NAME
Bill's House
NPCS
cerulean-house2-man bald3 5 3 RIGHT
INTERACTIONS
MENU:ALERT:Gym BADGEs are so pretty.|MENU:ALERT:It's a shame that they don't do anything.|FACE:RIGHT
END
TELEPORT
3 8 route25 45 8
2 8 route25 45 8
DATA
262 263 264 265 265 262 263 264
266 267 268 269 269 266 267 268
270 271 272 273 273 270 271 272
274 274 274 274 274 274 274 274
274 275 276 274 274 274 274 274
274 277 278 274 274 274 274 274
274 274 274 274 274 274 274 274
274 274 279 279 274 274 274 274
82  82  166 166  