NAME
Celadon City
MAP
0.0
0.1225
26
MUSIC
music/33-celadon-intro.mp3,music/33-celadon-loop.mp3
LEAVESOUND
sound_effects/general/sfx_go_inside.mp3
FLY_LOCATION
44
14
NPCS
celadon-city-sign1 blank 30 19
INTERACTIONS
MENU:ALERT:TRAINER TIPS|MENU:ALERT:X ACCURACY boosts the accuracy of techniques!|MENU:ALERT:It even clears accuracy debuffs!|MENU:ALERT:DIRE HIT jacks up the likelihood of critical hits!|MENU:ALERT:Get your items at CELADON DEPT. STORE!
END
celadon-city-sign2 blank 22 19
INTERACTIONS
MENU:ALERT:CELADON CITY {NEWLINE} The City of Rainbow Dreams
END
celadon-city-sign3 blank 24 13
INTERACTIONS
MENU:ALERT:CELADON MANSION
END
celadon-city-sign4 blank 30 25
INTERACTIONS
MENU:ALERT:ROCKET GAME CORNER The playground for grown-ups!
END
celadon-city-sign5 blank 36 25
INTERACTIONS
MENU:ALERT:Coins exchanged for prizes! {NEWLINE} PRIZE EXCHANGE
END
celadon-city-sign6 blank 42 25
INTERACTIONS
MENU:ALERT:TRAINER TIPS|MENU:ALERT:GUARD SPEC. protects POK{e-accent}MON from having their stats altered.|MENU:ALERT:Get your items at CELADON DEPT. STORE!
END
celadon-city-sign7 blank 16 33
INTERACTIONS
MENU:ALERT:CELADON CITY POK{e-accent}MON GYM LEADER: ERIKA|MENU:ALERT:The Nature Loving Princess!
END
celadon-city-old1 oldman 14 32 UP
INTERACTIONS
MENU:ALERT:Heheh! This GYM is great! It's full of women!|FACE:UP
END
celadon-city-rocket1 rocket 34 33 WANDER
INTERACTIONS
MENU:ALERT:What are you staring at?
END
celadon-city-old2 oldman 28 26 DOWN
INTERACTIONS
MENU:ALERT:Moan! I blew it all at the slots!|MENU:ALERT:I knew I should have cashed in my coins for prizes!|FACE:DOWN
END
celadon-city-girl1 girl2 12 22 WANDER
INTERACTIONS
MENU:ALERT:I got my KOFFING in CINNABAR!|MENU:ALERT:It's nice, but it breathes poison when it's angry!
END
celadon-city-old3 oldman 25 20 DOWN
INTERACTIONS
MENU:ALERT:Hello, there!|MENU:ALERT:I've seen you, but I never had a chance to talk!|MENU:ALERT:Here's a gift for dropping by!|GIVE_ITEM:TM41
MENU:ALERT:TM41 teaches SOFTBOILED!|MENU:ALERT:Only POK{e-accent}MON that are part CHANSEY can use it!
END
celadon-city-woman1 woman3 17 20 WANDER
INTERACTIONS
MENU:ALERT:The GAME CORNER is bad for our city's image!
END
celadon-city-mon1 mon 33 16 RIGHT
INTERACTIONS
PLAY_CRY:62-62|MENU:ALERT:POLIWRATH: Ribi ribit!|FACE:RIGHT
END
celadon-city-fat1 fat 35 16 LEFT
INTERACTIONS
MENU:ALERT:This is my trusted pal, POLIWRATH!|MENU:ALERT:It evolved from POLIWHIRL when I used a WATER STONE on it!|FACE:LEFT
END
celadon-city-rocket2 rocket 45 18 WANDER
INTERACTIONS
MENU:ALERT:Keep out of TEAM ROCKET's way!
END
celadon-city-item1 blank 51 19 INCORPOREAL
INTERACTIONS
GIVE_ITEM:PP UP|DEACTIVATE:celadon-city-item1
END
celadon-city-bush1 bush 50 24
INTERACTIONS
HAS_MOVE:CUT|{}{MENU:ALERT:Used CUT!|CUT:}
END
celadon-city-bush2 bush 38 36
INTERACTIONS
HAS_MOVE:CUT|{}{MENU:ALERT:Used CUT!|CUT:}
END
TELEPORT
53 14 route7 1 5
53 15 route7 1 6
44 13 celadon-center 3 7
46 31 celadon-house1 3 7
38 31 celadon-house2 3 7
34 31 celadon-house3 3 7
11 17 celadon-dept 2 8
13 17 celadon-dept 16 8
27 13 celadon-mansion 4 11
27 8 celadon-mansion 4 1
28 8 celadon-mansion 4 1
36 23 celadon-prize 4 7
31 23 celadon-game-corner 15 13
15 31 celadon-gym 4 17
0 22 route16 43 14
NEIGHBORS
route7 52 9
route16 -43 8
WATER_ENCOUNTERS_OLD
129
WATER_ENCOUNTERS_GOOD
60 118
WATER_ENCOUNTERS_SUPER
61 79 118
LEVELS
16-22
DATA
76   76  76  76  76  76  76  76  76  76  76  76  76  76  76  76  76  76  76  76  76  76  76  76  76  76  76  76  76  76  76  76  76  76  76  76  76  76  76  76  76  76  76  76  76  76  76  76  76  76  76  76  76  76  76  76  76
76   76  76  76  76  76  76  76  76  76  76  76  76  76  76  76  76  76  76  76  76  76  76  76  76  76  76  76  76  76  76  76  76  76  76  76  76  76  76  76  76  76  76  76  76  76  76  76  76  76  76  76  76  76  76  76  76
76   76  76  76  76  76  76  76  76  76  76  76  76  76  76  76  76  76  76  76  76  76  76  76  76  76  76  76  76  76  76  76  76  76  76  76  76  76  76  76  76  76  76  76  76  76  76  76  76  76  76  76  76  76  76  76  76
76   76  76  76  76  76  76  76  76  76  76  76  76  76  76  76  76  76  76  76  76  76  76  76  76  76  76  76  76  76  76  76  76  76  76  76  76  76  76  76  76  76  76  76  76  76  76  76  76  76  76  76  76  76  76  76  76
76   76  76  76  76  76  76  76  76  76  76  76  76  76  76  76  76  76  76  76  76  76  76  76  76  76  76  76  76  76  76  76  76  76  76  76  76  76  76  76  76  76  76  76  76  76  76  76  76  76  76  76  76  76  76  76  76
76   76  76  76  76   1   1   1   1   1   1   1   1   1   1   1   1   1   1   1   1   1   1   1   1   1   1   1   1   1   1   1   1   1   1   1   1   1   1   1   1   1   1   1   1   1   1   1   1   1   1  76  76  76  76  76  76
76   76  76  76  76   1   1   1   1   1   1   1   1   1   1   1   1   1   1   1   1   1   1   1   1   1   1   1   1   1   1   1   1   1   1   1   1   1   1   1   1   1   1   1   1   1   1   1   1   1   1   1  76  76  76  76  76
76   76  76  76  76   1   1   1   1   1   1   1   1   1   1   1   1   1   1   1   1   1   1  76  76  76  76   1   1  76  76  76  76  76  76   1   1  76  76  76  76  76  76  76  76  76  76  76  76   1   1   1  76  76  76  76  76
76   76  76  76  76 102  71  71 103 163 163 163 163 163 163 163 163 102  71  71  71  71 103 163 163 102  71 168 168  71 103 163 163 163 163 163 163 163 163 163 163 163 163 163 163 163 163 163 163  76   1   1  76  76  76  76  76
76   76  76  76  76 104  68  68 105 163 163 163 163 163 163 163 163 104  68  68  68  68 105 163 163 104  68  68  68  68 105 163 163 163 163 163 163 163 163 163 163 163 163 163 163 163 163 163 163  76   1   1  76  76  76  76  76
76   76  76  76  76 108  65  65 109 102  71  71  71  71  71  71 103 108  65  65  65  65 109 163 163 108  65  65  65  65 109 102  71  71 103 102  71  71 103 102  71  71 103 102  71  71 103 163 163  76   1   1  76  76  76  76  76
76   76  76  76  76 108  65  65 109 104  68  68  68  68  68  68 105 108  65  65  65  65 109 163 163 108  65  65  65  65 109 104  68  68 105 104  68  68 105 104  68  68 105 104  68  68 105 163 163  76   1   1  76  76
76   76  76  76  76 108  65  65 109 108  65  65  65  65  65  65 109 108  65  65  65  65 109 480 480 108  65  63  64  65 109 108  65  65 109 108  65  65 109 108  65  65 109 108  65  65 109 163 163  76  76  76  76  76
76   76  76  76  76 110 164 164 112 108  65  65  65  65  65  65 109 110 164 164 164 164 112 480   5 110 164  15  58 164 112 110 164 164 112 110 164 164 112 110 164 164 112 110  15 113 112 163 163  76  76  76  76  76
76   76  76  76  76 163 163 163 163 108  65  65  65  65  65  65 109 163 163 163 163 163 163 163 163 163 163 163 163 163 163 163 163 163 163 163 163 163 163 163 163 163 163 163 163 163 163 163 163 163 163 163 163  56
76   76  76  76  76 163 163 163 163 108  65  65  65  65  65  65 109 163 163 163 163 163 163 163 163 163 163 163 163 163 163 163 163 163 163 163 163 163 163 163 163 163 163 163 163 163 163 163 163 163 163 163 163  56
76   76  76  76  76 163 163 163 163 108  65  63  64  63  64  65 109 163 163 163 163 163 163 163 163 163 163 163 163 163 163 163 163 163 163 163 163 163 163 163 163 163 163 163 163 163 163 163 163  76  76  76  76  76
76   76  76  76  76 163 163 163 163 110 164  15  58  15  58 111 112 163 163 163 163 163 163 163 163 163 163 163 163 163 163 163 163 163 163 163 163 163 163 163 163 163 163 163 163 163 163 163 163  76  76  76  76  76
76   76  76  76  76 163 163 163 163 163 163 163 163 163 163 163 163 163 163 163 163 480 480   8   9   9   9   9  13  56  56  56  56  56  56  56  56  56  56 163 163  56  56  56  56  56  56  56  56  76  76  76  76  76
76   76  76  76  76 163 163 163 163 163 163 163 163 163 163 163 163 163 163 163 163 480   5   7  10 239  10  11  12  55   5  55  55  55  55  55  55  55  55 163 163  55  55  55  55  55  55  55  55  76  76  76  76  76
76   76  76  76  76 163 163 163 163 163 163 163 163 163 163 163 163 163 163 163 163 163 163   0   1 238 238   1   0 102  71  71  71  71 103 102  71  71 103 163 163 102  71  71 103 102  71  71 103  76  76   1  76  76
76   76  76  76  76 163 163 163 163 163 163 163 163 163 163 163 163 163 163 163 163 163 163   0   1 238 238   1   0 104  68  68  68  68 105 104  68  68 105 163 163 104  68  68 105 104  68  68 105  76  76   1  76  76  76
56   56  56  56  56 163 163 163 163 163 163 163 163 163 163 163 163 163 163 163 163 163 163   0  88  88  88  88   0 108  65  63  64  65 109 108  65  65 109 163 163 108  65  65 109 108  65  65 109  76  76   1  76  76  76
55   55  55  55  55 163 163 163 163 163 163 163 163 163 163 163 163 163 163 163 163 163 163   0  81  81  81  81   0 110 164  15  58 164 112 110  15 164 112 163 163 110 164 164 112 110 164 164 112  76  76   1  76  76  76
76   76  76  76  76 163 163 163 163 163 163 163 163 163 163 163 163 163 163 163 163 163 163   0  81  81  81  81   0  56  56  56  56  56  56  56  56  56  56 163 163  56  56  56  56  56  56  56  56   1   1   1  76  76  76
76   76  76  76  76 163 163 163 163 163 163 163 163 163 163 163 163 163 163 163 163 163 163   0  81  81  81  81   0  55   5  55  55  55  55  55   5  55  55 163 163  55   5  55  55  55  55  55  55  76   1   1  76  76  76
76   76  76  76  76 163 163 163 163 163 163 163 163 163 163 163 163 163 163 163 163 163 163 163 163 163 163 163 163 163 163 163 163 163 163 163 163 163 163 163 163 163 163 163 163 163 163 163 163  76   1   1  76  76  76
76   76  76  76  76 163 163 163 163 163 163 163 163 163 163 163 163 163 163 163 163 163 163 163 163 163 163 163 163 163 163 163 163 163 163 163 163 163 163 163 163 163 163 163 163 163 163 163 163  76   1   1  76  76  76
76   76  76  76  76 102  71  71 103  70  71  71  71  71  71  71  72 102  71  71 103 102  71  71 103 163 163 163 163 102  71  71 103 102  71  71 103 102  71  71 103 102  71  71 103 102  71  71 103   1   1   1  76  76  76  76  76
76   76  76  76  76 104  68  68 105  67  68  68  68  68  68  68  69 104  68  68 105 104  68  68 105 163 163 163 163 104  68  68 105 104  68  68 105 104  68  68 105 104  68  68 105 104  68  68 105   1   1   1  76  76  76  76  76
76   76  76  76  76 108  65  65 109  61  62 100 101 100 101  62  66 108  65  65 109 108  65  65 109 163 163 163 163 108  65  65 109 108  65  65 109 108  65  65 109 108  65  65 109 108  65  65 109   1   1   1  76  76  76  76  76
76   76  76  76  76 110 164 164 112  57  58  58  58  58  58  15  60 110 164 164 112 110 164 164 112 163 163 163 163 110 164 164 112 110  15 164 112 110  15 164 112 110 164 164 112 110  15 164 112   1   1   1  76  76  76  76  76
76   76  76  76  76 163 163 163 163 163 163 163 163 163 163 480 480 163 163 163 163 102  71  71 103 163 163 163 163 163 163 163 163 163 163 163 163 163 163 163 163 163 163 163 163 163 163 163 163   1   1   1  76  76  76  76  76
76   76  76  76  76 163 163 163 163 163 163 163 163 163 163 480   5 163 163 163 163 104  68  68 105 163 163 163 163 163 163 163 163 163 163 163 163 163 163 163 163 163 163 163 163 163 163 163 163   1   1   1  76  76  76  76  76
76   76  76  76  76   1   1   1   1   1   1   1   1   1   1   1   1   1   1   1   1 108  65  65 109 163 163 163 163 163 163 163 163 163 163 163 163 163 163 163 163 163 163 163 163 163 163 163 163   1   1   1  76  76  76  76  76
76   76  76  76  76  77  77  77  79  77  77  77  77  77  77  77  77  77  77  77  77 110 164 164 112 163 163 163 163 163 163 163 163 163 163 163 163 163 163 163 163 163 163 163 163 163 163 163 163   1   1   1  76  76  76  76  76
76   76  76  76  76   1   1   1   1   1   1   1   1   1   1   1   1   1   1   1   1   1   1   1   1  76  76  76  76  76  76  76  76  76  76  76  76  76   1  76  76  76  76  76  76  76  76  76  76   1   1   1  76  76  76  76  76
76   76  76  76  76   1   1   1   1   1   1   1   1   1   1   1   1   1   1   1   1   1   1   1   1   1   1   1   1   1   1   1   1   1   1   1   1  76   1   1  76   1   1   1   1   1   1   1   1   1   1   1  76  76  76  76  76
76   76  76  76  76   1   1   1   1   1   1   1   1   1   1   1   1   1   1   1   1   1   1   1   1   1   1   1   1   1   1   1   1   1   1   1   1   1   1  76  76   1   1   1   1   1   1   1   1   1   1  76  76  76  76  76  76
76   76  76  76  76  76  76  76  76  76  76  76  76  76  76  76  76  76  76  76  76  76  76  76  76  76  76  76  76  76  76  76  76  76  76  76  76  76  76   1  76  76  76  76  76  76  76  76  76  76  76  76  76  76  76  76  76
76   76  76  76  76  76  76  76  76  76  76  76  76  76  76  76  76  76  76  76  76  76  76  76  76  76  76  76  76  76  76  76  76  76  76  76  76  76  76  76  76  76  76  76  76  76  76  76  76  76  76  76  76  76  76  76  76
76   76  76  76  76  76  76  76  76  76  76  76  76  76  76  76  76  76  76  76  76  76  76  76  76  76  76  76  76  76  76  76  76  76  76  76  76  76  76  76  76  76  76  76  76  76  76  76  76  76  76  76  76  76  76  76  76
76   76  76  76  76  76  76  76  76  76  76  76  76  76  76  76  76  76  76  76  76  76  76  76  76  76  76  76  76  76  76  76  76  76  76  76  76  76  76  76  76  76  76  76  76  76  76  76  76  76  76  76  76  76  76  76  76
76   76  76  76  76  76  76  76  76  76  76  76  76  76  76  76  76  76  76  76  76  76  76  76  76  76  76  76  76  76  76  76  76  76  76  76  76  76  76  76  76  76  76  76  76  76  76  76  76  76  76  76  76  76  76  76  76