NAME
Celadon Department Store
NPCS
celadon-house3-bald bald3 1 4 DOWN
INTERACTIONS
MENU:ALERT:Psst! There's a basement under the GAME CORNER.|FACE:DOWN
END
TELEPORT
2 8 celadon-city 11 18
3 8 celadon-city 11 18
16 8 celadon-city 13 18
17 8 celadon-city 13 18
DATA
519 519 519 519 519 519 519 519 519 519 519 519 519 519 519 519 519 519 519 519
516 520 521 516 516 516 517 516 516 516 516 517 523 516 525 516 526 526 516 516
518 518 518 518 518 518 134 518 518 518 518 134 518 518 518 518 527 527 518 511
518 518 518 518 518 518 134 518 518 518 518 134 518 518 518 518 518 518 518 511
518 518 518 518 518 518 508 509 509 509 509 522 518 518 518 518 518 518 518 511
518 518 518 518 518 518 518 518 518 518 518 518 518 518 518 518 518 518 518 511
518 518 518 518 518 518 518 518 518 518 518 518 518 518 518 518 518 518 518 518
518 518  54  54 518 518 518 518 518 518 518 518 518 518 518 518  54  54 518 518
82   82 166 166  82  82  82  82  82  82  82  82  82  82  82  82 166 166
