NAME
Rocket Hideout
NPCS
celadon-game-corner-woman woman4 2 2 DOWN FARSPEAK
INTERACTIONS
MENU:ALERT:Welcome!|MENU:ALERT:You can exchange your coins for fabulous prizes next door.
END
TRAINERS
celadon-game-corner-rocker 35 0.45 0.45 ROCKET rocket.png {ROCKET: Dang!}{} 42-20:28|20-42:28
END
TELEPORT
15 14 celadon-city 31 24
16 14 celadon-city 31 24
DATA
82   82  82  82  82  82  82  82  82  82 594 597 597 597 597 597 597 595
82   82  82  82  82  82  82  82  82  82 599 600 600 600 600 600 600 599
82   82  82  82  82  82  82  82  82  82 599 600 600 488 600 489 600 599
82   82  82  82  82  82  82  82  82  82 599 600 600 600 600 600 600 599
594 597 597 597 597 597 597 597 597 597 597 598 600 600 600 600 596 597 597 597 597 595
599 600 600 600 600 600 600 600 600 600 600 600 600 600 600 600 600 600 600 600 600 599
599 600 600 600 600 600 600 600 600 600 600 600 600 600 600 600 600 600 600 600 600 599
599 600 600 600 600 600 600 600 600 600 600 600 600 600 600 600 600 600 600 600 600 599
594 597 598 600 600 596 597 595 501 600 600 600 600 501 594 597 598 600 600 596 597 595
599 600 600 600 600 600 600 599 500 600 600 600 600 500 599 600 600 600 600 600 600 599
599 600 600 600 600 600 600 599 501 600 600 600 600 501 599 600 600 600 600 600 600 599
599 600 600 600 600 600 600 599 500 600 600 600 600 500 599 600 600 600 600 600 600 599
599 600  48  52  48  52 600 599 501 600 600 600 600 501 599 600  48  52  48  52 600 599
599 600 601 602 601 602 600 599 500 600 600 600 600 500 599 600 601 602 601 602 600 599
599 501 600 600 600 600 600 599 501 600 600 600 600 501 599 501 600 600 600 600 600 599
599 500 600 600 600 600 600 599 500 600 600 600 600 500 599 500 600 600 600 600 600 599
594 597 597 597 597 597 597 597 597 597 597 597 597 597 597 595 600 600 596 597 597 595
599 600 600 600 600 600 600 600 600 600 600 600 600 600 600 599 600 600 600 600 600 599
599 501 600 600 600 600 600 600 600 600 600 600 600 600 600 599 600 600 600 600 600 599
599 500 600 600  48  52  48  52  48  52 600 600 600 600 600 599 603 605 596 597 597 598
599 501 600 600 349 352 349 352 349 352 600 600 600 600 600 599 166 166
599 500 600 600 349 352 349 352 349 352 600 600 600 600 600 599
599 501 600 600 349 352 349 352 349 352 600 600 600 600 600 599
599 500 600 600 349 352 349 352 349 352 600 600 600 600 600 599
599 501 600 600 601 602 601 602 601 602 600 600 600 498 600 599
599 500 600 600 600 600 600 600 600 600 600 600 600 600 600 599
599 600 600 600 600 600 600 600 600 600 600 600 600 600 600
594 597 597 597 597 597 597 597 597 597 597 597 597 597 597 595