NAME
Celadon Mansion
NPCS
celadon-dept-sign1 blank 2 2
INTERACTIONS
MENU:ALERT:This is an elevator.
END
TELEPORT
4 12 celadon-city 27 14
4 0 celadon-city 27 7
7 1 celadon-mansion 7 20
7 19 celadon-mansion 7 2
2 1 celadon-mansion 3 19
2 19 celadon-mansion 3 1
4 19 celadon-mansion 3 36
4 36 celadon-mansion 3 19
6 19 celadon-mansion 6 37
6 36 celadon-mansion 6 20
7 36 celadon-mansion 11 58
11 57 celadon-mansion 7 37
2 36 celadon-mansion 7 58
7 57 celadon-mansion 3 36
7 63 celadon-mansion 3 84
2 85 celadon-mansion 7 64
3 85 celadon-mansion 7 64
DATA
82  82   17  17 557 552  17  17
82  82  558 554 554 552 554 558
548 550 504 550 548 551 554 554
502  85 505  85 502 552 554 554
502 502 502 502 502 552 554 554
502 502 502 502 502 552 554 554
48   52 502 502 549 552 554 554
23   24 502 502 554 553 554 554
502 502 502 502 554 554 554 554
548 548 548 548 555 556 554 554
554 554 554 554 554 554 554 554
554 554 554 554 499 499 554 554
82   82  82  82 166 166
82
82
82
82
82
82   82  17  17  17 552  17  17
82   82 524 554 558 552 558 524
35   35  35  35  35 551 554 554
36   36  36  36  36 552 554 554
502 502 502 502 502 552 554 554
275 276 502 502 502 552 554 554
559 560 502 501 501 552 554 554
27  502 502 500 500 553 554 554
28  502 502 502 554 554 554 554
548 548 548 548 555 556 554 554
554 554 554 554 554 554 554 554
554 554 554 554 554 554 554 554
82
82
82
82
82
82   82  17  17  17 552  17  17
82   82 558 554 524 552 524 558
548 548 548 548 548 551 554 554
275 276 502 275 276 552 554 554
559 560 502 559 560 552 554 554
502 502 502 502 502 552 554 554
275 276 502 502 549 552 554 554
559 560 502 502 554 553 554 554
502 502 502 502 554 554 554 554
548 548 548 548 555 556 554 554
554 554 554 554 554 554 554 554
554 554 554 554 554 554 554 554
82
82
82
82
82
539 539 539 539 539 539 539 539 539 539 539 539 539 539 539 539 539 539
539 539 539 539 539 539 539 539 539 539 539 539 539 539 539 539 539 539
539 539 539 539 539 539 539 539 539 539 539 539 539 539 539 539 539 539
539 539 539 539 539 539 539 539 539 539 539 539 539 539 539 539 539 539
539 539 539 539 539 561 548 548 548 548 562 548 563 539 539 539 539 539
539 539 539 539 539 552 554 524 554 554 552 524 552 539 539 539 539 539
539 539 539 539 539 552 554 554 554 554 552 554 552 539 539 539 539 539
539 539 539 539 539 552 554 554 554 554 552 554 552 539 539 539 539 539
539 539 539 539 539 552 564 565 566 554 552 554 552 539 539 539 539 539
539 539 539 539 539 552 567 568 569 554 552 554 552 539 539 539 539 539
539 539 539 539 539 552 567 568 569 554 552 554 552 539 539 539 539 539
539 539 539 539 539 552 570 557 571 554 552 554 552 539 539 539 539 539
539 539 539 539 539 552 554 554 554 554 552 554 552 539 539 539 539 539
539 539 539 539 539 552 572 573 573 574 553 554 552 539 539 539 539 539
539 539 539 539 539 552 554 554 554 554 554 554 552 539 539 539 539 539
539 539 539 539 539 552 572 573 573 573 573 574 552 539 539 539 539 539
539 539 539 539 539 539 539 539 539 539 539 539 539 539 539 539 539 539
539 539 539 539 539 539 539 539 539 539 539 539 539 539 539 539 539 539
539 539 539 539 539 539 539 539 539 539 539 539 539 539 539 539 539 539
539 539 539 539 539 539 539 539 539 539 539 539 539 539 539 539 539 539
82
82
82
82
82
17 34  17 115 116 17 17 31
18 18  18  18  18 18 18 36
18 18  18  18  18 18 18 18
18 18  18 114  52 18 18 18
18 18  18 117  24 18 18 18
18 18  18  37  18 18 18 18
30 18  18  18  18 18 18 30
29 18  38  38  18 18 18 29
82 82 166 166