NAME
Cinnabar Island
MUSIC
music/39-cinnabar-intro.mp3,music/39-cinnabar-loop.mp3
LEAVESOUND
sound_effects/general/sfx_go_inside.mp3
NPCS
cinnabar-island-sign1 blank 18 7
INTERACTIONS
MENU:ALERT:CINNABAR ISLAND POK{e-accent}MON GYM|MENU:ALERT:LEADER: BLAINE|MENU:ALERT:The Hot-Headed Quiz Master!
END
cinnabar-island-sign2 blank 14 9
INTERACTIONS
MENU:ALERT:CINNABAR ISLAND The Fiery Town of Burning Desire
END
cinnabar-island-sign1 blank 14 15
INTERACTIONS
MENU:ALERT:POK{e-accent}MON LAB
END
cinnabar-island-man1 bald4 19 10
INTERACTIONS
MENU:ALERT:Scientists conduct experiments in the burned out building.
END
cinnabar-island-woman1 woman3 17 9 WANDER
INTERACTIONS
MENU:ALERT:CINNABAR GYM's BLAINE is an odd man who live here for decades.
END
TELEPORT
30 6 route20 1 6
30 7 route20 1 7
30 8 route20 1 8
30 9 route20 1 9
30 10 route20 1 10
30 11 route20 1 11
30 12 route20 1 12
30 13 route20 1 13
30 14 route20 1 14
30 15 route20 1 15
30 16 route20 1 16
30 17 route20 1 17
30 18 route20 1 18
30 19 route20 1 19
30 20 route20 1 20
20 15 cinnabar-mart 3 7
16 15 cinnabar-center 3 7
11 13 cinnabar-lab 2 5
11 7 cinnabar-mansion 5 27
23 7 cinnabar-gym 16 17
6 0 route21 6 86
7 0 route21 7 86
8 0 route21 8 86
9 0 route21 9 86
10 0 route21 10 86
11 0 route21 11 86
12 0 route21 12 86
13 0 route21 13 86
14 0 route21 14 86
15 0 route21 15 86
16 0 route21 16 86
17 0 route21 17 86
18 0 route21 18 86
19 0 route21 19 86
NEIGHBORS
route20 29 0
route21 0 -86
ENCOUNTERS
37 58 78 126
WATER_ENCOUNTERS_OLD
129
WATER_ENCOUNTERS_GOOD
60 118
WATER_ENCOUNTERS_SUPER
73 90 119 120
LEVELS
47-52
DATA
81   81  81  81  81 656  81  81  81  81  81  81  81  81  81  81  81  81  81  81 656  81  81  81  81  81  81  81  81  81  81
81   81  81  81  81 656  81  81  81  81  81  81  81  81  81  81  81  81  81  81 656  81  81  81  81  81  81  81  81  81  81
81   81  81  81  81 656  81  81  81  81  81  81  81  81  81 238 238  81  81  81 656  81  81  81  81  81  81  81  81  81  81
81   81  81  81  81 656  81  81  81  81  81  81  81  81  81 238 238  81  81  81 656  81  81  81  81  81  81  81  81  81  81
81   81  81  81  81 656  81  81  89 102  71  71  71  71 103 482 482 482 482  70  71  71  71  71  72  81  81  81  81  81  81
81   81  81  81  81 656  81  81  89 104  68  68  68  68 105 482 482 482 482  67  68  68  68  68  69 656 656 656 656 656 656
81   81  81  81  81 656  81  81  89 108  65  63  64  65 109 482 482 480 480  61  62 100 101  62  66  90  81  81  81  81  81
81   81  81  81  81 656  81  81  89 110 164  15  58 164 112 482 482 480   5  57  58  58  58  15  60  90  81  81  81  81  81
81   81  81  81  81 656  81  81  89 482 482 482 482 480 480 482 482 482 482 482 482 482 482 482 482  90  81  81  81  81  81
81   81  81  81  81 656  81  81  89 482 482 482 482 480   5 482 482 482 482 482 482 482 482 482 482  90  81  81  81  81  81
81   81  81  81  81 656  81  81  89 102  71  71  71  71 103 482 482 482 482 482 482 482 482 482 482  90  81  81  81  81  81
81   81  81  81  81 656  81  81  89 104  68  68  68  68 105 482 482 482 482 482 482 482 482 482 482  90  81  81  81  81  81
81   81  81  81  81 656  81  81  89 108  65  63  64  65 109 102  71  71 103 102  71  71 103 482 482  90  81  81  81  81  81
81   81  81  81  81 656  81  81  89 110 164  15  58 164 112 104  68  68 105 104  68  68 105 482 482  90  81  81  81  81  81
81   81  81  81  81 656  81  81  89 482 482 482 482 480 480 108  65  65 109 108  65  65 109 482 482  90  81  81  81  81  81
81   81  81  81  81 656  81  81  89 482 482 482 482 480   5 110  15 113 112 110  15 111 112 482 482  90  81  81  81  81  81
81   81  81  81  81 656  81  81  87  88  91 482 482 482 482 482 482 482 482 482 482 482 482 482 482  90  81  81  81  81  81
81   81  81  81  81 656  81  81  81  81  89 482 482 482 482 482 482 482 482 482 482 482 482 482 482  90  81  81  81  81  81
81   81  81  81  81 656  81  81  81  81  87  88  88  88  88  88  88  88  88  88  88  88  88  88  88  86  81  81  81  81  81
81   81  81  81  81 656  81  81  81  81  81  81  81  81  81  81  81  81  81  81  81  81  81  81  81  81  81  81  81  81  81
81   81  81  81  81 656  81  81  81  81  81  81  81  81  81  81  81  81  81  81  81  81  81  81  81  81  81  81  81  81  81
81   81  81  81  81 656 656 656 656 656 656 656 656 656 656 656 656 656 656 656 656 656 656 656 656 656 656 656 656 656 656
81   81  81  81  81  81  81  81  81  81  81  81  81  81  81  81  81  81  81  81  81  81  81  81  81  81  81  81  81  81  81
81   81  81  81  81  81  81  81  81  81  81  81  81  81  81  81  81  81  81  81  81  81  81  81  81  81  81  81  81  81  81
81   81  81  81  81  81  81  81  81  81  81  81  81  81  81  81  81  81  81  81  81  81  81  81  81  81  81  81  81  81  81
81   81  81  81  81  81  81  81  81  81  81  81  81  81  81  81  81  81  81  81  81  81  81  81  81  81  81  81  81  81  81
81   81  81  81  81  81  81  81  81  81  81  81  81  81  81  81  81  81  81  81  81  81  81  81  81  81  81  81  81  81  81