NAME
Diglett's Cave
DUNGEON
MUSIC
music/12-viridian-forest-intro.mp3,music/12-viridian-forest-loop.mp3
LEAVESOUND
sound_effects/general/sfx_go_outside.mp3
NPCS
diglett-cave-bald1 bald4 6 5
INTERACTIONS
MENU:ALERT:What a surprise! DIGLETTs dug this long tunnel!|MENU:ALERT:It goes right to VIRIDIAN CITY!
END
diglett-cave-safari1 safari 7 16
INTERACTIONS
MENU:ALERT:I went to ROCK TUNNEL, but it's dark and scary.|MENU:ALERT:If a POK{e-accent}MON's FLASH could light it up...
END
TELEPORT
6 10 route11 5 10
7 10 route11 5 10
6 21 route2 17 10
7 21 route2 17 10
7 32 digletts-cave 7 17
8 17 digletts-cave 6 32
8 6 digletts-cave 38 58
39 58 digletts-cave 7 6
ENCOUNTERS
27 50 46
MEGA_ENCOUNTERS
28 51 47
LEVELS
15-22
MEGA_LEVELS
28-30
DATA
231 231 231 231 231 231 231 231 231 231 231 231 231 231 231
231 231 231 231 231 231 231 231 231 231 231 231 231 231 231
231 231 231 231 231 231 231 231 231 231 231 231 231 231 231
231 231 231 231 231 231 231 231 231 231 231 231 231 231 231
231 231 231 231 231 201 201 201 201 201 231 231 231 231 231
231 231 231 231 231 201 201 201 201 201 231 231 231 231 231
231 231 231 231 231 201 201 201 227 201 231 231 231 231 231
231 231 231 231 231 201 201 201 201 201 231 231 231 231 231
231 231 231 231 231 201 201 201 201 201 231 231 231 231 231
231 231 231 231 231 231 225 225 231 231 231 231 231 231 231
231 231 231 231 231 231 457 457 231 231 231 231 231 231 231
231 231 231 231 231 231 231 231 231 231 231 231 231 231 231
231 231 231 231 231 231 231 231 231 231 231 231 231 231 231
231 231 231 231 231 231 231 231 231 231 231 231 231 231 231
231 231 231 231 231 231 231 231 231 231 231 231 231 231 231
231 231 231 231 231 201 201 201 201 201 231 231 231 231 231
231 231 231 231 231 201 201 201 201 201 231 231 231 231 231
231 231 231 231 231 201 201 201 227 201 231 231 231 231 231
231 231 231 231 231 201 201 201 201 201 231 231 231 231 231
231 231 231 231 231 201 201 201 201 201 231 231 231 231 231
231 231 231 231 231 231 225 225 231 231 231 231 231 231 231
231 231 231 231 231 231 457 457 231 231 231 231 231 231 231
231 231 231 231 231 231 231 231 231 231 231 231 231 231 231
231 231 231 231 231 231 231 231 231 231 231 231 231 231 231
231 231 231 231 231 231 231 231 231 231 231 231 231 231 231
231 231 231 231 231 231 231 231 231 231 231 231 231 231 231
224 224 224 224 224 224 224 224 224 224 224 224 224 224
224 224 224 224 224 224 224 224 224 224 224 224 224 224
224 224 224 224 224 224 224 224 224 224 224 224 224 224
224 224 224 224 224 224 224 224 224 224 224 224 224 224
224 224 224 224 224 222 216 216 223 224 224 224 224 224
224 224 224 224 224 218 201 201 215 224 224 224 224 224
224 224 224 224 224 218 201 228 215 224 224 224 224 224
224 224 224 224 224 218 201 201 215 224 224 224 224 224
224 224 224 224 224 218 201 201 215 224 224 224 224 224
224 224 224 224 224 218 201 201 215 224 224 224 224 224
224 224 224 224 224 218 201 201 215 224 224 224 224 224 224 224 224 224
224 224 224 224 224 218 201 201 215 224 224 224 224 224 224 224 224 224
224 224 224 224 224 218 201 201 215 224 224 224 224 224 224 224 224 224
224 224 224 224 224 218 201 201 215 224 224 224 224 224 224 224 224 224
224 224 224 224 224 218 201 201 214 216 216 216 223 224 224 224 224 224 224 224 224 224
224 224 224 224 224 218 201 201 201 201 201 201 215 224 224 224 224 224 224 224 224 224
224 224 224 224 224 218 201 201 201 201 201 201 215 224 224 224 224 224 224 224 224 224
224 224 224 224 224 218 201 201 201 201 201 201 215 224 224 224 224 224 224 224 224 224
224 224 224 224 224 218 201 201 201 201 201 201 214 216 216 216 223 224 224 224 224 224
224 224 224 224 224 224 210 210 210 221 201 201 201 201 201 201 215 224 224 224 224 224
224 224 224 224 224 224 224 224 224 218 201 201 201 201 201 201 215 224 224 224 224 224
224 224 224 224 224 224 224 224 224 218 201 201 201 201 201 201 215 224 224 224 224 224
224 224 224 224 224 224 224 224 224 218 201 201 201 201 201 201 215 224 224 224 224 224 224 224 224 224 224 224 224 224 224 224 224 224
224 224 224 224 224 224 224 224 224 224 210 210 210 221 201 201 215 224 224 224 224 224 224 224 224 224 224 224 224 224 224 224 224 224
224 224 224 224 224 224 224 224 224 224 224 224 224 218 201 201 215 224 224 224 224 224 224 224 224 224 224 224 224 224 224 224 224 224
224 224 224 224 224 224 224 224 224 224 224 224 224 218 201 201 215 224 224 224 224 224 224 224 224 224 224 224 224 224 224 224 224 224
224 224 224 224 224 224 224 224 224 224 224 224 224 218 201 201 214 216 216 216 216 216 216 216 216 216 216 216 223 224 224 224 224 224 224 224 224 224 224 224 224 224 224 224 224 224
224 224 224 224 224 224 224 224 224 224 224 224 224 218 201 201 201 201 201 201 201 201 201 201 201 201 201 201 215 224 224 224 224 224 224 224 224 224 224 224 224 224 224 224 224 224
224 224 224 224 224 224 224 224 224 224 224 224 224 218 201 201 201 201 201 201 201 201 201 201 201 201 201 201 215 224 224 224 224 224 224 224 224 224 224 224 224 224 224 224 224 224
224 224 224 224 224 224 224 224 224 224 224 224 224 218 201 201 201 201 201 201 201 201 201 201 201 201 201 201 215 224 224 224 224 224 224 224 224 224 224 224 224 224 224 224 224 224
224 224 224 224 224 224 224 224 224 224 224 224 224 218 201 201 201 201 201 201 201 201 201 201 201 201 201 201 214 216 216 216 216 216 216 216 216 216 216 216 223 224 224 224 224 224
224 224 224 224 224 224 224 224 224 224 224 224 224 224 210 210 210 210 210 210 210 210 210 210 210 221 201 201 201 201 201 201 201 201 201 201 201 201 201 201 215 224 224 224 224 224
224 224 224 224 224 224 224 224 224 224 224 224 224 224 224 224 224 224 224 224 224 224 224 224 224 218 201 201 201 201 201 201 201 201 201 201 201 201 201 228 215 224 224 224 224 224
224 224 224 224 224 224 224 224 224 224 224 224 224 224 224 224 224 224 224 224 224 224 224 224 224 224 210 210 210 210 210 210 210 210 210 221 201 201 201 201 215 224 224 224 224 224
224 224 224 224 224 224 224 224 224 224 224 224 224 224 224 224 224 224 224 224 224 224 224 224 224 224 224 224 224 224 224 224 224 224 224 218 201 201 201 201 215 224 224 224 224 224
224 224 224 224 224 224 224 224 224 224 224 224 224 224 224 224 224 224 224 224 224 224 224 224 224 224 224 224 224 224 224 224 224 224 224 224 210 210 210 210 224 224 224 224 224 224
224 224 224 224 224 224 224 224 224 224 224 224 224 224 224 224 224 224 224 224 224 224 224 224 224 224 224 224 224 224 224 224 224 224 224 224 224 224 224 224 224 224 224 224 224 224
224 224 224 224 224 224 224 224 224 224 224 224 224 224 224 224 224 224 224 224 224 224 224 224 224 224 224 224 224 224 224 224 224 224 224 224 224 224 224 224 224 224 224 224 224 224
224 224 224 224 224 224 224 224 224 224 224 224 224 224 224 224 224 224 224 224 224 224 224 224 224 224 224 224 224 224 224 224 224 224 224 224 224 224 224 224 224 224 224 224 224 224
224 224 224 224 224 224 224 224 224 224 224 224 224 224 224 224 224 224 224 224 224 224 224 224 224 224 224 224 224 224 224 224 224 224 224 224 224 224 224 224 224 224 224 224 224 224