NAME
Home
TELEPORT
7 1 home 6 20
7 20 home 6 1
2 27 pallet-town 5 6
3 27 pallet-town 5 6
DATA
19 21 22 17 17 16 17 16
20 23 24 18 18 18 18 39
18 18 18 18 18 18 18 18
18 18 18 18 18 18 18 18
18 18 18 25 18 18 18 18
18 18 18 26 18 18 18 18
27 18 18 18 18 18 30 18
28 18 18 18 18 18 29 18
82
82
82
82
82
82
82
82
82
82
82
35 35 17 16 17 16 17 16
36 36 18 25 18 18 18 40
18 18 18 18 18 18 18 18
18 18 18 18 18 18 18 18
18 18 37 74 73 37 18 18
18 18 37 23 24 37 18 18
18 18 18 18 18 18 18 18
18 18 41 41 18 18 18 18
82 82 81 81