NAME
Mt. Moon
NPCS
route4-girl girl 10 8
INTERACTIONS
MENU:ALERT:Ouch! I tripped over a rocky POK{e-accent}MON, GEODUDE!
END
TELEPORT
14 36 route4 20 6
15 36 route4 20 6
DATA
206 207 206 210 210 210 210 210 210 210 210 210 210 210 210 210 210 210 210 210 210 210 210 210 210 210 210 210 210 210 210 210 210 210 210 210 210 210 210 210
204 205 202 211 211 211 211 211 211 211 211 211 211 211 211 211 211 211 211 211 211 211 211 211 211 211 211 211 211 211 211 211 211 211 211 211 211 211 211 203
204 205 201 201 201 201 201 201 201 201 201 201 206 207 201 201 201 201 201 201 201 201 201 201 201 201 201 201 201 201 201 201 201 201 201 201 201 201 206 207
204 205 201 201 201 201 201 201 201 201 201 201 204 205 201 201 201 201 201 201 201 201 201 201 201 201 201 201 201 201 201 201 201 201 201 201 201 201 204 205
204 205 201 201 201 201 201 201 201 201 201 201 204 205 201 201 201 201 201 201 201 201 201 201 201 201 201 201 201 201 201 201 201 201 201 201 201 201 204 205
204 205 201 201 201 227 201 201 201 201 201 201 204 205 201 201 201 201 201 201 201 201 201 201 201 201 201 201 201 201 201 201 201 201 201 201 201 201 204 205
204 205 201 201 201 201 201 201 201 201 201 201 204 205 201 201 201 201 201 201 201 201 201 201 201 201 201 201 201 201 201 201 201 201 201 201 201 201 204 205
204 205 201 201 201 201 201 201 201 201 201 201 204 205 201 201 201 201 201 201 201 201 201 201 201 201 201 201 201 201 201 201 201 201 201 201 201 201 204 205
204 205 201 201 201 201 201 201 201 201 201 201 204 205 201 201 201 201 206 210 210 207 206 210 210 207 206 210 210 207 201 201 201 201 201 201 201 201 204 205
204 205 201 201 201 201 201 201 201 201 201 201 204 205 201 201 201 201 202 211 211 203 202 211 211 203 202 211 211 203 201 201 201 201 201 201 201 201 204 205
204 205 201 201 201 201 201 201 201 201 201 201 204 205 201 201 201 201 206 207 201 201 201 201 201 201 201 201 201 201 201 201 201 201 201 201 201 201 204 205
204 205 201 201 201 201 201 201 201 201 201 201 204 205 201 201 201 227 204 205 201 201 201 201 201 201 201 201 201 201 201 201 201 201 201 201 201 201 204 205
204 205 201 201 201 201 201 201 201 201 201 201 204 205 201 201 201 201 204 205 201 201 201 201 201 201 201 201 201 201 201 201 206 207 201 201 201 201 204 205
204 205 201 201 201 201 201 201 201 201 201 201 204 205 201 201 201 201 202 203 201 201 201 201 201 201 201 201 201 201 201 201 204 205 201 201 201 201 204 205
204 205 201 201 201 201 201 201 201 201 201 201 204 205 201 201 201 201 206 207 201 201 201 201 201 201 201 201 201 201 201 201 204 205 201 201 201 201 204 205
204 205 201 201 201 201 201 201 201 201 201 201 202 203 201 201 201 201 204 205 201 201 201 201 201 227 201 201 201 201 201 201 202 203 201 201 201 201 204 205
204 205 201 201 201 201 201 201 201 201 201 201 201 201 201 201 201 201 204 205 201 201 206 207 201 201 201 201 201 201 201 201 206 207 201 201 201 201 204 205
204 205 201 201 201 201 201 201 201 201 201 201 201 201 201 201 201 201 202 203 201 201 204 205 201 201 201 201 201 201 201 201 204 205 201 201 201 201 204 205
204 205 206 210 210 210 210 207 206 207 201 201 201 201 201 201 201 201 206 207 201 201 204 205 201 201 201 201 201 201 201 201 204 205 201 201 201 201 204 205
204 205 202 211 211 211 211 203 204 205 201 201 201 201 201 201 201 201 204 205 201 201 202 203 201 201 201 201 201 201 201 201 202 203 201 201 201 201 204 205
204 205 201 201 201 201 201 201 204 205 206 210 210 210 210 210 210 207 204 205 201 201 206 207 201 201 201 201 201 201 201 201 206 207 201 201 201 201 204 205
204 205 201 201 201 201 201 201 204 205 202 211 211 211 211 211 211 203 202 203 201 201 204 205 201 201 201 201 201 201 201 201 204 205 201 201 201 201 204 205
204 205 201 201 201 201 201 201 204 205 201 201 201 201 201 201 201 201 201 201 201 201 204 205 201 201 201 201 201 201 201 201 204 205 201 201 201 201 204 205
204 205 201 201 201 201 201 201 202 203 201 201 201 201 201 226 201 201 201 201 201 201 202 203 201 201 201 201 201 201 201 201 202 203 201 201 201 201 204 205
204 205 201 201 201 201 201 201 201 201 201 201 201 201 201 201 201 201 201 201 201 201 206 207 201 201 201 201 201 201 201 201 206 207 201 201 201 201 204 205
204 205 201 201 201 201 201 201 201 201 201 201 201 201 201 201 201 201 201 201 201 201 202 203 201 201 201 201 201 201 201 201 204 205 201 201 201 201 204 205
204 205 201 201 201 201 201 201 201 201 201 201 201 201 201 201 219 210 210 221 206 210 210 207 201 201 219 210 210 221 201 201 204 205 201 201 201 201 204 205
204 205 201 201 201 201 201 201 201 201 201 201 201 201 201 201 215 224 224 218 202 211 211 203 201 201 215 224 224 218 201 201 202 203 201 201 201 201 204 205
204 205 201 201 201 201 201 201 201 201 201 201 201 201 201 201 215 224 224 218 201 201 201 201 201 201 215 224 224 218 201 201 201 201 201 201 201 201 204 205
204 205 201 201 201 201 201 201 201 201 201 201 201 201 201 201 215 224 224 218 201 201 201 201 201 201 215 224 224 218 201 201 201 201 201 201 201 201 204 205
204 205 201 201 201 201 201 201 201 201 219 210 210 221 201 201 215 224 224 218 201 201 201 201 201 201 215 224 224 218 201 201 201 201 201 201 201 201 204 205
204 205 201 201 201 201 201 201 201 201 215 224 224 218 201 201 215 224 224 218 201 201 201 201 201 201 214 216 216 217 201 201 201 201 201 201 201 201 204 205
204 205 201 201 201 201 201 201 201 201 215 224 224 218 201 201 215 224 224 218 201 201 201 201 201 201 201 201 201 201 201 201 201 201 201 201 201 201 204 205
204 205 201 201 201 201 201 201 201 201 215 224 224 218 201 201 215 224 224 218 201 201 201 201 201 201 201 201 201 201 201 201 201 201 201 201 201 201 202 203
204 205 206 210 210 210 210 210 210 207 215 224 224 218 201 201 215 224 224 218 206 210 210 210 210 210 210 210 210 210 210 210 210 210 210 210 210 210 210 207
204 205 202 211 211 211 211 211 211 203 214 216 216 217 225 225 214 216 216 217 202 211 211 211 211 211 211 211 211 211 211 211 211 211 211 211 211 211 211 203
82   82  82  82  82  82  82  82  82  82  82  82  82  82 166 166
82
82
82
82
82
82
82
216 216 216 216 216 216 216 216 216 216 216 216 216 216 216 216 216 216 216 216 216 216 216 216 216 216 216 216 216 216 216 216 216 216 216 216 210 210 210 210
216 216 216 216 216 216 216 216 216 216 216 216 216 216 216 216 216 216 216 216 216 216 216 216 216 216 216 216 216 216 216 216 216 216 216 216 232 232 232 205
229 229 219 233 233 233 233 233 233 233 233 233 233 233 233 233 233 221 229 229
229 229 215 224 224 224 224 224 224 224 224 224 224 224 224 224 224 218 229 229
229 229 215 224 224 224 224 224 224 224 224 224 224 224 224 224 224 218 229 229
229 229 214 230 216 216 216 216 216 216 216 223 224 224 222 216 216 217 229 229
229 229 224 224 224 224 224 224 219 233 233 233 224 224 233 233 233 221 229 229
229 229 224 224 224 228 224 224 215 224 224 224 224 224 224 224 224 221 229 229
229 229 224 224 224 224 224 224 215 224 224 224 224 224 224 224 224 221 229 229
229 229 229 229 229 229 229 229 214 216 216 216 230 230 223 224 224 221 229 229
216 216 216 216 216 216 229 229 224 224 224 224 224 224 215 224 224 221 229 229
216 216 216 216 216 216 229 229 224 224 224 224 224 224 214 216 216 217 229 229
201 201 201 201 201 201 229 229 224 224 224 224 224 224 224 224 224 224 229 229
201 201 201 201 201 201 229 229 229 229 229 229 224 224 229 229 229 229 229 229
201 201 201 201 201 201
201 201 201 201 201 201
201 201 201 201 201 201
201 201 201 201 201 201
201 201 201 201 201 201
201 201 201 201 201 201
201 201 201 201 201 201
201 201 201 201 201 201
201 201 201 201 201 201
201 201 201 201 201 201
201 201 201 201 201 201
201 201 201 201 201 201
201 201 201 201 201 201
201 201 201 201 201 201
201 201 201 201 201 201
201 201 201 201 201 201
201 201 201 201 201 201