NAME
Mt. Moon
NPCS
route4-girl girl 10 8
INTERACTIONS
MENU:ALERT:Ouch! I tripped over a rocky POK{e-accent}MON, GEODUDE!
END
TELEPORT
14 36 route4 20 6
15 36 route4 20 6
5 5 mt-moon 1 94
1 93 mt-moon 5 6
18 110 mt-moon 21 60
21 61 mt-moon 17 110
5 51 mt-moon 3 155
3 156 mt-moon 5 52
4 156 route4 1 1
17 11 mt-moon 10 144
11 144 mt-moon 16 11
3 146 mt-moon 25 52
25 53 mt-moon 3 145
25 15 mt-moon 17 120
16 120 mt-moon 24 15
3 134 mt-moon 15 70
15 71 mt-moon 3 133
DATA
206 207 206 210 210 210 210 210 210 210 210 210 210 210 210 210 210 210 210 210 210 210 210 210 210 210 210 210 210 210 210 210 210 210 210 210 210 210 210 210
204 205 202 211 211 211 211 211 211 211 211 211 211 211 211 211 211 211 211 211 211 211 211 211 211 211 211 211 211 211 211 211 211 211 211 211 211 211 211 203
204 205 201 201 201 201 201 201 201 201 201 201 206 207 201 201 201 201 201 201 201 201 201 201 201 201 201 201 201 201 201 201 201 201 201 201 201 201 206 207
204 205 201 201 201 201 201 201 201 201 201 201 204 205 201 201 201 201 201 201 201 201 201 201 201 201 201 201 201 201 201 201 201 201 201 201 201 201 204 205
204 205 201 201 201 201 201 201 201 201 201 201 204 205 201 201 201 201 201 201 201 201 201 201 201 201 201 201 201 201 201 201 201 201 201 201 201 201 204 205
204 205 201 201 201 227 201 201 201 201 201 201 204 205 201 201 201 201 201 201 201 201 201 201 201 201 201 201 201 201 201 201 201 201 201 201 201 201 204 205
204 205 201 201 201 201 201 201 201 201 201 201 204 205 201 201 201 201 201 201 201 201 201 201 201 201 201 201 201 201 201 201 201 201 201 201 201 201 204 205
204 205 201 201 201 201 201 201 201 201 201 201 204 205 201 201 201 201 201 201 201 201 201 201 201 201 201 201 201 201 201 201 201 201 201 201 201 201 204 205
204 205 201 201 201 201 201 201 201 201 201 201 204 205 201 201 201 201 206 210 210 207 206 210 210 207 206 210 210 207 201 201 201 201 201 201 201 201 204 205
204 205 201 201 201 201 201 201 201 201 201 201 204 205 201 201 201 201 202 211 211 203 202 211 211 203 202 211 211 203 201 201 201 201 201 201 201 201 204 205
204 205 201 201 201 201 201 201 201 201 201 201 204 205 201 201 201 201 206 207 201 201 201 201 201 201 201 201 201 201 201 201 201 201 201 201 201 201 204 205
204 205 201 201 201 201 201 201 201 201 201 201 204 205 201 201 201 227 204 205 201 201 201 201 201 201 201 201 201 201 201 201 201 201 201 201 201 201 204 205
204 205 201 201 201 201 201 201 201 201 201 201 204 205 201 201 201 201 204 205 201 201 201 201 201 201 201 201 201 201 201 201 206 207 201 201 201 201 204 205
204 205 201 201 201 201 201 201 201 201 201 201 204 205 201 201 201 201 202 203 201 201 201 201 201 201 201 201 201 201 201 201 204 205 201 201 201 201 204 205
204 205 201 201 201 201 201 201 201 201 201 201 204 205 201 201 201 201 206 207 201 201 201 201 201 201 201 201 201 201 201 201 204 205 201 201 201 201 204 205
204 205 201 201 201 201 201 201 201 201 201 201 202 203 201 201 201 201 204 205 201 201 201 201 201 227 201 201 201 201 201 201 202 203 201 201 201 201 204 205
204 205 201 201 201 201 201 201 201 201 201 201 201 201 201 201 201 201 204 205 201 201 206 207 201 201 201 201 201 201 201 201 206 207 201 201 201 201 204 205
204 205 201 201 201 201 201 201 201 201 201 201 201 201 201 201 201 201 202 203 201 201 204 205 201 201 201 201 201 201 201 201 204 205 201 201 201 201 204 205
204 205 206 210 210 210 210 207 206 207 201 201 201 201 201 201 201 201 206 207 201 201 204 205 201 201 201 201 201 201 201 201 204 205 201 201 201 201 204 205
204 205 202 211 211 211 211 203 204 205 201 201 201 201 201 201 201 201 204 205 201 201 202 203 201 201 201 201 201 201 201 201 202 203 201 201 201 201 204 205
204 205 201 201 201 201 201 201 204 205 206 210 210 210 210 210 210 207 204 205 201 201 206 207 201 201 201 201 201 201 201 201 206 207 201 201 201 201 204 205
204 205 201 201 201 201 201 201 204 205 202 211 211 211 211 211 211 203 202 203 201 201 204 205 201 201 201 201 201 201 201 201 204 205 201 201 201 201 204 205
204 205 201 201 201 201 201 201 204 205 201 201 201 201 201 201 201 201 201 201 201 201 204 205 201 201 201 201 201 201 201 201 204 205 201 201 201 201 204 205
204 205 201 201 201 201 201 201 202 203 201 201 201 201 201 226 201 201 201 201 201 201 202 203 201 201 201 201 201 201 201 201 202 203 201 201 201 201 204 205
204 205 201 201 201 201 201 201 201 201 201 201 201 201 201 201 201 201 201 201 201 201 206 207 201 201 201 201 201 201 201 201 206 207 201 201 201 201 204 205
204 205 201 201 201 201 201 201 201 201 201 201 201 201 201 201 201 201 201 201 201 201 202 203 201 201 201 201 201 201 201 201 204 205 201 201 201 201 204 205
204 205 201 201 201 201 201 201 201 201 201 201 201 201 201 201 219 210 210 221 206 210 210 207 201 201 219 210 210 221 201 201 204 205 201 201 201 201 204 205
204 205 201 201 201 201 201 201 201 201 201 201 201 201 201 201 215 224 224 218 202 211 211 203 201 201 215 224 224 218 201 201 202 203 201 201 201 201 204 205
204 205 201 201 201 201 201 201 201 201 201 201 201 201 201 201 215 224 224 218 201 201 201 201 201 201 215 224 224 218 201 201 201 201 201 201 201 201 204 205
204 205 201 201 201 201 201 201 201 201 201 201 201 201 201 201 215 224 224 218 201 201 201 201 201 201 215 224 224 218 201 201 201 201 201 201 201 201 204 205
204 205 201 201 201 201 201 201 201 201 219 210 210 221 201 201 215 224 224 218 201 201 201 201 201 201 215 224 224 218 201 201 201 201 201 201 201 201 204 205
204 205 201 201 201 201 201 201 201 201 215 224 224 218 201 201 215 224 224 218 201 201 201 201 201 201 214 216 216 217 201 201 201 201 201 201 201 201 204 205
204 205 201 201 201 201 201 201 201 201 215 224 224 218 201 201 215 224 224 218 201 201 201 201 201 201 201 201 201 201 201 201 201 201 201 201 201 201 204 205
204 205 201 201 201 201 201 201 201 201 215 224 224 218 201 201 215 224 224 218 201 201 201 201 201 201 201 201 201 201 201 201 201 201 201 201 201 201 202 203
204 205 206 210 210 210 210 210 210 207 215 224 224 218 201 201 215 224 224 218 206 210 210 210 210 210 210 210 210 210 210 210 210 210 210 210 210 210 210 207
204 205 202 211 211 211 211 211 211 203 214 216 216 217 225 225 214 216 216 217 202 211 211 211 211 211 211 211 211 211 211 211 211 211 211 211 211 211 211 203
82   82  82  82  82  82  82  82  82  82  82  82  82  82 166 166
82
82
82
82
82
82
82
216 216 216 216 216 216 216 216 216 216 216 216 216 216 216 216 216 216 216 216 216 216 216 216 216 216 216 216 216 216 216 216 216 216 216 216 210 210 210 210 210 210 210 210 210 210 210
216 216 216 216 216 216 216 216 216 216 216 216 216 216 216 216 216 216 216 216 216 216 216 216 216 216 216 216 216 216 216 216 216 216 216 216 232 232 232 232 232 232 232 232 232 232 205
229 229 219 233 233 233 233 233 233 233 233 233 233 233 233 233 233 221 229 229 216 216 216 216 216 216 216 216 216 216 216 216 216 216 216 216 232 232 232 232 232 232 232 232 232 232 205
229 229 215 224 224 224 224 224 224 224 224 224 224 224 224 224 224 218 229 229 216 216 216 216 216 216 216 216 216 216 216 216 216 216 216 216 232 232 232 232 232 232 232 232 232 232 205
229 229 215 224 224 224 224 224 224 224 224 224 224 224 224 224 224 218 229 229 216 216 216 216 216 216 216 216 216 216 216 216 216 216 216 216 232 232 232 232 232 232 232 232 232 232 205
229 229 214 230 216 216 216 216 216 216 216 223 224 224 222 216 216 217 229 229 224 224 224 222 216 216 223 233 233 233 233 222 216 216 216 216 232 232 232 232 232 232 232 232 232 232 205
229 229 224 224 224 224 224 224 219 233 233 233 224 224 233 233 233 221 229 229 224 224 224 218 201 201 215 224 224 224 224 218 201 201 201 201 232 232 232 232 232 232 232 232 232 232 205
229 229 224 224 224 228 224 224 215 224 224 224 224 224 224 224 224 218 229 229 224 224 224 218 201 201 214 216 230 230 216 217 201 201 201 201 232 232 232 232 232 232 232 232 232 232 205
229 229 224 224 224 224 224 224 215 224 224 224 224 224 224 224 224 218 229 229 224 224 224 218 201 201 201 201 201 201 201 201 201 201 201 201 216 216 216 216 216 216 216 216 216 216 216
229 229 229 229 229 229 229 229 214 216 216 216 230 230 223 224 224 218 229 229 224 224 224 218 201 227 201 201 201 201 201 201 201 231 201 201 216 216 216 216 216 216 216 216 216 216 216
216 216 216 216 216 216 229 229 224 224 224 224 224 224 215 224 224 218 229 229 224 224 224 218 201 201 201 201 201 201 201 201 201 201 201 201 216 216 216 216 216 216 216 216 216 216 216
216 216 216 216 216 216 229 229 224 224 224 224 224 224 214 216 216 217 229 229 224 224 224 218 201 201 201 201 201 201 201 201 201 201 201 201 216 216 216 216 216 216 216 216 216 216 216
201 201 201 201 201 201 229 229 224 224 224 224 224 224 224 224 224 224 229 229 224 224 224 224 233 233 233 233 233 221 219 233 233 233 233 233 224 224 224 222 216 216 216 216 216 216 216
201 201 201 201 201 201 229 229 229 229 229 229 224 224 229 229 229 229 229 229 224 224 224 224 224 224 224 224 224 218 215 224 224 224 224 224 224 224 224 218 201 201 201 201 201 201 201
201 201 201 201 201 201 216 216 216 216 216 216 224 224 216 216 216 216 229 229 224 224 224 224 224 224 224 224 224 218 215 224 224 224 224 224 224 224 224 218 201 201 201 201 201 201 201
201 201 201 201 201 201 216 216 216 216 216 216 224 224 216 216 216 216 229 229 224 224 224 224 222 216 230 230 216 217 214 216 230 230 216 223 224 224 224 218 201 201 201 201 201 201 201
201 201 201 201 201 201 215 224 224 224 224 224 224 224 224 224 224 224 229 229 224 224 224 224 218 201 201 201 201 201 201 201 201 201 201 215 224 224 224 218 201 201 201 201 201 201 201
201 201 201 201 201 201 215 224 224 224 224 224 224 224 224 224 224 224 229 229 224 228 224 224 218 201 201 201 201 201 201 201 201 201 201 215 224 224 224 218 201 201 201 201 201 201 201
201 201 201 201 201 201 215 224 224 224 224 224 224 224 224 224 224 224 229 229 224 224 224 224 218 201 201 201 201 201 201 201 201 201 201 215 224 224 224 218 201 201 201 201 201 201 201
201 201 201 201 201 201 215 224 224 224 224 224 229 229 229 229 229 229 229 229 229 229 229 229 229 229 229 229 229 229 229 229 229 229 229 229 224 224 224 218 201 201 201 201 201 201 201
201 201 201 201 201 201 215 224 224 224 224 224 229 229 216 216 216 216 216 216 216 216 216 216 216 216 216 216 216 216 229 229 216 216 216 216 224 224 224 218 201 201 201 201 201 201 201
201 201 201 201 201 201 215 224 224 224 224 224 229 229 216 216 216 216 216 216 216 216 223 233 233 233 233 222 216 216 229 229 216 216 216 216 224 224 224 218 201 201 201 201 201 201 201
201 201 201 201 201 201 215 224 224 224 224 224 229 229 224 224 224 224 224 224 224 224 215 224 224 224 224 218 224 224 229 229 224 224 224 224 224 224 224 218 201 201 201 201 201 201 201
201 201 201 201 201 201 215 224 224 224 224 224 229 229 224 224 224 224 224 224 224 224 214 216 230 230 216 217 224 224 229 229 224 224 224 224 224 224 224 218 201 201 201 201 201 201 201
201 201 201 201 201 201 215 224 224 224 224 224 229 229 224 224 224 224 224 224 224 224 224 224 224 224 224 224 224 224 229 229 224 224 224 224 224 224 224 218 201 201 201 201 201 201 201
201 201 201 201 201 201 215 224 224 224 224 224 229 229 224 224 224 224 224 224 224 224 224 224 224 224 224 224 224 224 229 229 224 224 224 222 216 216 216 217 201 201 201 201 201 201 201
201 201 201 201 201 201 215 224 224 224 224 224 229 229 224 224 224 224 224 224 224 224 224 224 224 224 224 224 224 224 229 229 224 224 224 218 201 201 201 201 201 201 201 201 201 201 201
201 201 201 201 201 201 215 224 224 224 224 224 229 229 224 228 224 224 224 224 224 224 224 224 224 224 224 224 224 224 229 229 224 224 224 218 201 201 201 201 201 201 201 201 201 201 201
201 201 201 201 201 201 215 224 224 224 224 224 229 229 229 229 229 229 229 229 229 229 229 229 229 229 229 229 229 229 229 229 224 224 224 218 201 201 201 201 201 201 201 201 201 201 201
201 201 201 201 201 201 215 224 224 224 224 224 216 216 216 216 216 216 216 216 216 216 216 216 216 216 216 216 216 216 216 216 224 224 224 218 201 201 201 201 201 201 201 201 201 201 201
201 201 201 201 201 201 215 224 224 224 224 224 216 216 216 216 216 216 216 216 216 216 216 216 216 216 216 216 216 216 216 216 224 224 224 218 201 201 201 201 201 201 201 201 201 201 201
201 201 201 201 201 201 215 224 224 224 224 224 224 224 224 224 224 224 224 224 224 224 224 224 224 224 224 224 224 224 224 224 224 224 224 218 201 201 201 201 201 201 201 201 201 201 201
201 201 201 201 201 201 215 224 224 224 224 224 224 224 224 224 224 224 224 224 224 224 224 224 224 224 224 224 224 224 224 224 224 224 224 218 201 201 201 201 201 201 201 201 201 201 201
201 201 201 201 201 201 214 216 216 216 216 216 216 216 216 216 216 216 216 216 216 216 216 216 216 216 216 216 216 216 216 216 216 216 216 217 201 201 201 201 201 201 201 201 201 201 201
201 201 201 201 201 201 201 201 201 201 201 201 201 201 201 201 201 201 201 201 201 201 201 201 201 201 201 201 201 201 201 201 201 201 201 201 201 201 201 201 201 201 201 201 201 201 201
201 201 201 201 201 201 201 201 201 201 201 201 201 201 201 201 201 201 201 201 201 201 201 201 201 201 201 201 201 201 201 201 201 201 201 201 201 201 201 201 201 201 201 201 201 201 201
201 201 201 201 201 201 201 201 201 201 201 201 201 201 201 201 201 201 201 201 201 201 201 201 201 201 201 201 201 201 201 201 201 201 201 201 201 201 201 201 201 201 201 201 201 201 201
201 201 201 201 201 201 201 201 201 201 201 201 201 201 201 201 201 201 201 201 201 201 201 201 201 201 201 201 201 201 201 201 201 201 201 201 201 201 201 201 201 201 201 201 201 201 201
201 201 201 201 201 201 201 201 201 201 201 201 201 201 201 201 201 201 201 201 201 201 201 201 201 201 201 201 201 201 201 201 201 201 201 201 201 201 201 201 201 201 201 201 201 201 201
201 201 201 201 201 201 201 201 201 201 201 201 201 201 201 201 201 201 201 201 201 201 201 201 201 201 201 201 201 201 201 201 201 201 201 201 201 201 201 201 201 201 201 201 201 201 201
82
82
82
82
82
82
82
216 216 216 216
224 224 224 224
224 228 224 224
224 224 224 224
224 224 224 224
224 224 224 224
224 224 224 224
224 224 224 224
224 224 224 224
224 224 224 224
224 224 224 224
224 224 224 224
224 224 224 224
224 224 224 224
224 224 224 224
224 224 224 224
224 224 224 224
224 224 224 224 216 216 216 216 216 216 216 216 216 216 216 216 216 216 216
224 224 224 224 224 224 224 224 224 224 224 224 224 224 224 224 224 224 224
224 224 224 224 224 224 224 224 224 224 224 224 224 224 224 224 224 224 227
82
82
82
82
82
82
82
82   82  82  82  82  82  82  82  82  82  82  82  82  82  82 216 216 216 216
82   82  82  82  82  82  82  82  82  82  82  82  82  82  82 224 224 224 224
82   82  82  82  82  82  82  82  82  82  82  82  82  82  82 224 228 224 224
82   82  82  82  82  82  82  82  82  82  82  82  82  82  82 224 224 224 224
82   82  82  82  82  82  82  82  82  82  82  82  82  82  82 224 224 224 224
82   82  82  82  82  82  82  82  82  82  82  82  82  82  82 224 224 224 224
82   82  82  82  82  82  82  82  82  82  82  82  82  82  82 224 224 224 224
82   82  82  82  82  82  82  82  82  82  82  82  82  82  82 224 224 224 224
82   82  82  82  82  82  82  82  82  82  82  82  82  82  82 224 224 224 224
82   82  82  82  82  82  82  82  82  82  82  82  82  82  82 224 224 224 224
82   82  82  82  82  82  82  82  82  82  82  82  82  82  82 224 224 224 224
82   82  82  82  82  82  82  82  82  82  82  82  82  82  82 224 224 224 224
82   82  82  82  82  82  82  82  82  82  82  82  82  82  82 224 224 224 224
82   82  82  82  82  82  82  82  82  82  82  82  82  82  82 224 224 224 224
224 224 224 224 224 224 224 224 224 224 224 224 224 224 224 224 224 224 224
224 224 224 224 224 224 224 224 224 224 224 224 224 224 224 224 224 224 224
224 224 224 227 224 224 224 224 224 224 224 224 224 224 224 224 224 224 224
82
82
82
82
82
82
82
216 216 216 216 216 216 216 216 216 216 216 216
224 224 224 224 224 224 224 224 224 224 224 224
224 224 224 224 224 224 224 224 224 224 224 228
224 224 224 224 224 224 224 224 224 224 224 224
224 224 224 227 224 224 224 224 224 224 224 224
82
82
82
82
82
82
82
216 216 216 216 216 216 216 216
224 224 224 224 224 224 224 224
224 224 224 227 224 224 224 228