NAME
Oak's Lab
TELEPORT
4 12 pallet-town 12 12
5 12 pallet-town 12 12
DATA
83 83 83 83 42 42 84 84 84 84
43 45 48 52 47 47 85 85 85 85
44 46 44 46 47 47 47 47 47 47
47 47 47 47 47 47 48 50 52 47
47 47 47 47 47 47 49 51 53 47
47 47 47 47 47 47 47 47 47 47
84 84 84 84 47 47 84 84 84 84
85 85 85 85 47 47 85 85 85 85
47 47 47 47 47 47 47 47 47 47
47 47 47 47 47 47 47 47 47 47
47 47 47 47 47 47 47 47 47 47
47 47 47 47 54 54 47 47 47 47
82 82 82 82 81 81
