NAME
Pewter City Museum
NPCS
pewter-mart-shelf1 blank 4 4
INTERACTIONS
MENU:ALERT:Wow! Tons of POK{e-accent}MON stuff!
END
TELEPORT
10 8 pewter-city 14 12
11 8 pewter-city 14 12
16 8 pewter-city 19 10
17 8 pewter-city 19 10
7 7 pewter-museum 6 21
7 21 pewter-museum 6 7
DATA
458 458 458 458 458 458 458 479 458 479 458 459 447 447 447 447 447 447 447 447
182 182 182 182 182 182 182 182 182 182 182 134 446 446 446 446 446 446 446 446
182 460 461 462 463 182 182 182 182 182 182 134  37 182 182 182 478 182 182 182
182 464 465 466 467 182 182 182 182 182 182 134  37 182 182 182 182 182 182 182
182 182 182 182 182 182 182 182 182 182 182 134 182 182 182 182 182 182 182 182
182 460 461 462 463 182 182 182 183 182 182 184 304 305 183 182 182 182 182 182
182 464 465 466 467 182 182 182 134 182 182 182 182  30 134 182 182 182 182  30
182 182 182 182 182 182 182  40 134 182 185 185 182  29 134 182 185 185 182  29
82   82  82  82  82  82  82  82  82  82 166 166  82  82  82  82 166 166
82
82
82
82
82
458 458 458 458 458 458 458 458 458 458 458 458 458 458
182 182 182 182 182 182 182 182 182 182 472 473 474 182
182 182 182 182 182 182 182 182 182 182 475 476 477 182
182 182 182 182 182 182 182 182 182 182 182 182 182 182
182 468 469 470 471 182 182 182 182 182 182 182 182 182
182 464 465 466 467 182 182 182 183 182 182 182 182 182
182 182 182 182 182 182 182 182 134 182 182 182 182 182
182 182 182 182 182 182 182  39 134 182 182 182 182 182
82   82  82 166 166