NAME
Pok{e-accent}mon Tower Base
NPCS
lavender-town-sign1 blank 13 10
INTERACTIONS
MENU:ALERT:New SILPH SCOPE!|MENU:ALERT:Make the Invisible Plain to See!|MENU:ALERT:SILPH CO.
END
TELEPORT
8 18 lavender-town 18 13
9 18 lavender-town 18 13
DATA
82   82  82  82  82  82 487 487 487 487 487 487
82   82  82  82 487 487 487 490 490 490 490 487 487 487
82   82  82 487 487 487 490 490 490 490 490 490 487 487 487
82   82 487 487 490 490 490 490 490 490 490 490 490 490 487 487
82  487 487 490 490 490 490 490 490 490 490 490 490 490 490 487 487
82  487 487 490 490 490 490 490 490 490 490 490 490 490 490 487 487
487 487 490 490 490 490 490 490 490 490 490 490 490 490 490 490 487 487
487 490 490 490 490 490 490 490 490 490 490 490 490 490 490 490 490 487
487 490 490 490 490 490 490 490 490 490 490 490 490 490 490 490 490 487
487 490 490 490 490 490 490 490 490 490 490 490 490 490 490 490 488 487
487 490 490 490 490 490 490 490 490 490 490 490 490 490 490 490 490 487
487 487 490 490 490 490 490 490 490 490 490 490 490 490 490 490 487 487
82  487 490 490 490 490 490 490 490 490 490 484 486 486 486 486 487
82  487 490 490 490 490 490 490 490 490 490 485 490 490 490 490 487
82   82 487 487 490 490 490 490 490 490 490 485 490 490 487 487
82   82  82 487 490 490 490 490 490 490 490 485 490 490 487
82   82  82  82 487 487 487 490 490 490 490 487 487 487
82   82  82  82  82  82 487 487 490 490 487 487
82   82  82  82  82  82  82  82 166 166
82
82
82
82
82
82
82   82  82  82  82  82 487 487 487 487 487 487
82   82  82  82 487 487 487 491 491 491 491 487 487 487
82   82  82 487 487 487 491 490 490 490 490 490 487 487 487
82   82 487 487 491 491 491 490 490 490 490 490 490 490 487 487
82  487 487 491 491 491 490 490 490 490 490 490 490 490 490 487 487
82  487 487 490 490 490 490 490 490 490 490 490 490 490 490 487 487
487 487 490 490 490 490 491 491 491 491 491 491 490 490 490 490 487 487
487 490 490 490 490 490 491 491 490 490 490 490 490 490 490 490 490 487
487 490 490 490 491 491 491 491 490 490 491 491 491 491 490 490 490 487
487 488 490 490 491 491 491 491 490 490 491 491 491 491 490 490 489 487
487 490 490 490 490 490 491 491 490 490 490 490 490 490 490 490 490 487
487 487 490 490 490 490 491 491 490 490 490 490 490 490 490 490 487 487
82  487 490 490 491 491 491 491 491 491 490 484 486 486 486 486 487
82  487 490 491 491 491 491 491 491 491 490 485 490 490 490 490 487
82   82 487 487 490 490 490 490 490 490 490 485 490 490 487 487
82   82  82 487 490 490 490 490 490 490 490 485 490 490 487
82   82  82  82 487 487 487 491 491 491 491 487 487 487
82   82  82  82  82  82 487 487 490 490 487 487
82   82  82  82  82  82  82 487 487 487 487