NAME
Rival's Home
TELEPORT
2 8 pallet-town 13 6
3 8 pallet-town 13 6
DATA
31 31 17 33 17 34 17 35
32 32 18 18 18 18 18 36
18 18 18 18 18 18 18 18
18 18 37 48 50 37 18 18
18 18 37 23 24 37 18 18
18 18 18 18 18 18 18 18
30 18 18 18 18 18 18 30
29 18 38 38 18 18 18 29
0  0  0  0
