NAME
Route 11
NPCS
route11-sign1 blank 2 9
INTERACTIONS
MENU:ALERT:DIGLETT's CAVE
END
TELEPORT
0 10 vermilion-city 43 16
0 11 vermilion-city 43 17
ENCOUNTERS
16 19 21 23 27 43 50 69
WATER_ENCOUNTERS_OLD
129
WATER_ENCOUNTERS_GOOD
60 118
WATER_ENCOUNTERS_SUPER
72 90 98 116
LEVELS
14-20
DATA
76  76  76  76  76  76  76  76  76  76  76  76  76  76  76  76  76  76  76  76  76  76  76  76  76  76  76  76  76  76  76  76  76  76  76  76  76  76  76  76  76  76  76  76  76  76  76  76  76  76  76  76  76  76  76  76  76  76  76  76  76  76  76
76  76  76  76  76  76  76  76  76  76  76  76  76  76  76  76  76  76  76  76  76  76  76  76  76  76  76  76  76  76  76  76  76  76  76  76  76  76  76  76  76  76  76  76  76  76  76  76  76  76  76  76  76  76  76  76  76  76  76  76  76  76  76
76  76  76  76  76  76  76  76  76  76  76  76  76  76  76  76  76  76  76  76  76  76  76  76  76  76  76  76  76  76  76  76  76  76  76  76  76  76  76  76  76  76  76  76  76  76  76  76  76  76  76  76  76  76  76  76  76  76  76  76  76  76  76
76  76  76  76  76  76  76  76  76  76  76  76  76  76  76  76  76  76  76  76  76  76  76  76  76  76  76  76  76  76  76  76  76  76  76  76  76  76  76  76  76  76  76  76  76  76  76  76  76  76  76  76  76  76  76  76  76  76  76  76  76  76  76
56  56  56  56  56  56  56  56  56  76   1 322 323 323 323 323 323 323 323 323 323 323 323 323 324   4   4   4   4   4   4 322 323 323 323 323 323 323 323 323 323 323 324   4   4   4   4   1   1   1   1   1   1   1   1   1   1  76  76  76  76  76  76
56  56  56  56  56  56  56  56  56  76   1 242 328 326 326 326 326 326 326 326 326 326 326 330 243   4   4   4   4   4   4 242 328 326 326 326 326 326 326 326 326 330 243   4   4   4   4   1   1   1   1   1   1   1   1   1   1  76  76  76  76  76  76
56  56  56 165 106 106 106 106 107  76   1 242 243   4   4   4   4   4   4   4   4   4   4 242 243   4   4   4   4   4   4 242 243   4   4   4   4   4   4   4   4 242 243   4   4   4   4   1   1   1   1   1   1   1   1   1   1  76  76  76  76  76  76
56  56  56 158  96  96  96  96  97  76   1 242 243   4   4   4   4   4   4   4   4   4   4 242 243   4   4   4   4   4   4 242 243   4   4   4   4   4   4   4   4 295 296   4   4   4   4   1   1   1   1   1   1   1   1   1   1  76  76  76  76  76  76
56  56  56 158  96  96  96  96  97  76   1 242 243   4   4   4   4   4   4   4   4   4   4 242 243   4   4   4   4   4   4 242 243   4   4   4   4   4   4   4   4   4   4   4   4   4   4   1   1   1   1   1   1   1   1   1   1  76  76  76  76  76  76
55  55   5 162  99 167  99  99  98  76   1 242 243   4   4   4   4   4   4   4   4   4   4 242 243   4   4   4   4   4   4 242 243   4   4   4   4   4   4   4   4   4   4   4   4   4   4   1   1  76   1   1   1   1   1   1   1  76  76  76  76  76  76
56  56  56  56  56  56  56  56  56  56  56 331 243   4   4   4   4 322 323 323 323 323 323 331 243   4   4   4   4   4   4 242 329 323 323 323 323 323 324   4   4   4   4   4   4   4   4   1   1   1   1 102  71  71  71  71  71  71 103  76  76  76  76
56  56  56  56  56  56  56  56  56  56  56 330 243   4   4   4   4 242 328 326 326 326 326 330 243   4   4   4   4   4   4 242 328 326 326 326 326 330 243   4   4   4   4   4   4   4   4  76  76  76  76 104  68  68  68  68  68  68 105  76  76   1  76
88  88  88  88  88  88  88  88  91  76   1 242 243   4   4   4   4 242 243   4   4   4   4 242 243   4   4   4   4   4   4 242 243   4   4   4   4 242 243   4   4   4   4   4   4   2   3   2   3   2   3 453  65  65  65  65  65  65 455   1   1   1   1
81  81  81  81  81  81  81  81  89  76   1 242 243   4   4   4   4 242 243   4   4   4   4 242 243   4   4   4   4   4   4 242 243   4   4   4   4 242 243   4   4   4   4   4   4   3   2   3   2   3   2 454 164 164 164 164 164 164 456   1   1  76   1
81  81  81  81  81  81  81  81  89  76   1 242 329 323 323 323 323 331 243   4   4   4   4 242 329 323 323 323 323 323 323 331 243   4   4   4   4 242 243   4   4   4   4   4   4 240 241  76  76  76  76  76   1   1   1   1   1  76  76  76  76  76  76
81  81  81  81  81  81  81  81  89  76   1 325 326 326 326 326 326 326 327   4   4   4   4 325 326 326 326 326 326 326 326 330 243   4   4   4   4 242 243   4   4   4   4   4   4 242 243   1   1   1   1   1   1   1   1   1   1  76  76  76  76  76  76
81  81  81  81  81  81  81  81  89  76   1   4   4   4   4   4   4   4   4   4   4   4   4   4   4   4   4   4   4   4   4 242 243   4   4   4   4 242 243   4   4   4   4   4   4 242 243   1   1   1   1   1   1   1   1   1   1  76  76  76  76  76  76
81  81  81  81  81  81  81  81  89  76   1   4   4   4   4   4   4   4   4   4   4   4   4   4   4   4   4   4   4   4   4 242 243   4   4   4   4 242 243   4   4   4   4   4   4 242 243   1   1   1   1   1   1   1   1   1   1  76  76  76  76  76  76
76  76  76  76  76  76  76  76  76  76   1 240 241   4   4   4   4   4   4   4   4   4   4   4   4   4   4   4   4   4   4 242 329 323 323 323 323 331 243   4   4   4   4   4   4 242 243   1   1   1   1   1   1   1   1   1   1  76  76  76  76  76  76
76  76  76  76  76  76  76  76  76  76   1 242 243   4   4   4   4   4   4   4   4   4   4   4   4   4   4   4   4   4   4 242 328 326 326 326 326 330 243   4   4   4   4   4   4 242 243   1   1   1   1   1   1   1   1   1   1  76  76  76  76  76  76
76  76  76  76  76  76  76  76  76  76  76 242 329 323 323 323 323 323 323 323 323 323 323 323 323 323 323 323 323 323 323 331 243   4   4   4   4 242 329 323 323 323 323 323 323 331 243   1   1   1   1   1   1   1   1   1   1  76  76  76  76  76  76
76  76  76  76  76  76  76  76  76  76  76 325 326 326 326 326 326 326 326 326 326 326 326 326 326 326 326 326 326 326 326 326 327   4   4   4   4 325 326 326 326 326 326 326 326 326 327   1   1   1   1   1   1   1   1   1   1  76  76  76  76  76  76
76  76  76  76  76  76  76  76  76  76  76  76  76  76  76  76  76  76  76  76  76  76  76  76  76  76  76  76  76  76  76  76  76  76  76  76  76  76  76  76  76  76  76  76  76  76  76  76  76  76  76  76  76  76  76  76  76  76  76  76  76  76  76
76  76  76  76  76  76  76  76  76  76  76  76  76  76  76  76  76  76  76  76  76  76  76  76  76  76  76  76  76  76  76  76  76  76  76  76  76  76  76  76  76  76  76  76  76  76  76  76  76  76  76  76  76  76  76  76  76  76  76  76  76  76  76
76  76  76  76  76  76  76  76  76  76  76  76  76  76  76  76  76  76  76  76  76  76  76  76  76  76  76  76  76  76  76  76  76  76  76  76  76  76  76  76  76  76  76  76  76  76  76  76  76  76  76  76  76  76  76  76  76  76  76  76  76  76  76
76  76  76  76  76  76  76  76  76  76  76  76  76  76  76  76  76  76  76  76  76  76  76  76  76  76  76  76  76  76  76  76  76  76  76  76  76  76  76  76  76  76  76  76  76  76  76  76  76  76  76  76  76  76  76  76  76  76  76  76  76  76  76