NAME
Route 11 Checkpoint
NPCS
route11-sign1 blank 2 9
INTERACTIONS
MENU:ALERT:DIGLETT's CAVE
END
TELEPORT
0 4 route11 50 13
0 5 route11 50 13
DATA
82  298 298 298 298 298 298 298 298  82
82  298 182 182 182 182 182 182 298  82
82  298 303 304 304 304 304 305 298  82
82  182 182 182 182 182 182 182 182  82
166 496 182 182 182 182 182 182 496 166
166 497 182 182 182 182 182 182 497 166
82  182 182 182 182 182 182 182 182
82  298 303 304 304 305 182 298 298
82  298 182 182 182 134 182  40 298
82  298 298 298 298 298 298 298 298
82
82
82
82
82  645 646 645 647 645 647 648 647
82  649 650 649 651 649 651 652 651
82  182 683 182 182 182 182 683 182
82  182 684 182 182 182 182 684 182