NAME
Route 23
NPCS
route23-sign1 blank 8 33
INTERACTIONS
MENU:ALERT:VICTORY ROAD GATE - POK{e-accent}MON LEAGUE
END
route23-checkpoint-guard1 guard3 13 136 DOWN
FORCE_INTERACTION
1 0
-1 0
-2 0
END
INTERACTIONS
MENU:ALERT:You can only go through here if you have a CASCADEBADGE.|GET:CASCADEBADGE|{MOVE:PLAYER:0,1|NO_ADVANCE}{DISABLE_FORCE|MENU:ALERT:Oh! That is a CASCADEBADGE!|MENU:ALERT:Go right ahead!}
MENU:ALERT:Oh! That is a CASCADEBADGE!|MENU:ALERT:Go right ahead!
END
route23-checkpoint-guard2 guard3 13 119 DOWN
FORCE_INTERACTION
1 0
END
INTERACTIONS
MENU:ALERT:You can only go through here if you have a THUNDERBADGE.|GET:THUNDERBADGE|{MOVE:PLAYER:0,1|NO_ADVANCE}{DISABLE_FORCE|MENU:ALERT:Oh! That is a THUNDERBADGE!|MENU:ALERT:Go right ahead!}
MENU:ALERT:Oh! That is a THUNDERBADGE!|MENU:ALERT:Go right ahead!
END
route23-checkpoint-guard3 guard3 17 105 DOWN
FORCE_INTERACTION
-2 0
-1 0
1 0
2 0
3 0
END
INTERACTIONS
MENU:ALERT:You can only go through here if you have a RAINBOWBADGE.|GET:RAINBOWBADGE|{MOVE:PLAYER:0,1|NO_ADVANCE}{DISABLE_FORCE|MENU:ALERT:Oh! That is a RAINBOWBADGE!|MENU:ALERT:Go right ahead!}
MENU:ALERT:Oh! That is a RAINBOWBADGE!|MENU:ALERT:Go right ahead!
END
route23-checkpoint-guard4 manswim 16 96 DOWN
FORCE_INTERACTION
-3 0
-2 0
-1 0
1 0
2 0
END
INTERACTIONS
MENU:ALERT:You can only go through here if you have a SOULBADGE.|GET:SOULBADGE|{MOVE:PLAYER:0,1|NO_ADVANCE}{DISABLE_FORCE|MENU:ALERT:Oh! That is a SOULBADGE!|MENU:ALERT:Go right ahead!}
MENU:ALERT:Oh! That is a SOULBADGE!|MENU:ALERT:Go right ahead!
END
route23-checkpoint-guard5 manswim 13 85 DOWN
FORCE_INTERACTION
-4 0
-3 0
-2 0
-1 0
1 0
2 0
3 0
4 0
5 0
END
INTERACTIONS
MENU:ALERT:You can only go through here if you have a MARSHBADGE.|GET:MARSHBADGE|{MOVE:PLAYER:0,1|NO_ADVANCE}{DISABLE_FORCE|MENU:ALERT:Oh! That is a MARSHBADGE!|MENU:ALERT:Go right ahead!}
MENU:ALERT:Oh! That is a MARSHBADGE!|MENU:ALERT:Go right ahead!
END
route23-checkpoint-guard6 guard3 15 56 DOWN
FORCE_INTERACTION
2 0
3 0
END
INTERACTIONS
MENU:ALERT:You can only go through here if you have a VOLCANOBADGE.|GET:VOLCANOBADGE|{MOVE:PLAYER:0,1|NO_ADVANCE}{DISABLE_FORCE|MENU:ALERT:Oh! That is a VOLCANOBADGE!|MENU:ALERT:Go right ahead!}
MENU:ALERT:Oh! That is a VOLCANOBADGE!|MENU:ALERT:Go right ahead!
END
route23-checkpoint-guard7 guard3 9 35 DOWN
FORCE_INTERACTION
-4 0
-3 0
-2 0
-1 0
1 0
2 0
3 0
END
INTERACTIONS
MENU:ALERT:You can only go through here if you have a EARTHBADGE.|GET:EARTHBADGE|{MOVE:PLAYER:0,1|NO_ADVANCE}{DISABLE_FORCE|MENU:ALERT:Oh! That is a EARTHBADGE!|MENU:ALERT:Go right ahead!}
MENU:ALERT:Oh! That is a EARTHBADGE!|MENU:ALERT:Go right ahead!
END
TELEPORT
12 140 route22-checkpoint 4 2
13 140 route22-checkpoint 4 2
ENCOUNTERS
22 24 28 20 33 57 128 132
WATER_ENCOUNTERS_OLD
129
WATER_ENCOUNTERS_GOOD
60 118
WATER_ENCOUNTERS_SUPER
61 80 99 117 119
LEVELS
55-60
DATA
76  76  76  76  76 765 766 766 766 766 765 766 765 767 769 769 767 765 766 765 766 766 766 766 765  76  76  76  76  76
76  76  76  76  76 765 766 766 766 766 765 766 765 768 769 769 768 765 766 765 766 766 766 766 765  76  76  76  76  76
76  76  76  76  76 765 766 766 766 766 765 766 765 767 769 769 767 765 766 765 766 766 766 766 765  76  76  76  76  76
76  76  76  76  76 765 766 766 766 766 765 766 765 768 769 769 768 765 766 765 766 766 766 766 765  76  76  76  76  76
76  76  76  76  76 765 766 766 765 772 770 772 770 767 769 769 767 770 772 770 772 765 766 766 765  76  76  76  76  76
76  76  76  76  76 765 766 766 765 773 771 773 771 768 769 769 768 771 773 771 773 765 766 766 765  76  76  76  76  76
76  76  76  76  76 765 766 766 765 769 769 767 769 769 767 769 769 769 769 769 769 765 766 766 765  76  76  76  76  76
76  76  76  76  76 765 766 766 765 769 769 768 769 769 768 769 769 769 769 769 769 765 766 766 765  76  76  76  76  76
76  76  76  76  76 765 766 766 765 769 767 769 769 769 769 767 769 767 769 767 769 765 766 766 765  76  76  76  76  76
76  76  76  76  76 765 766 766 765 769 768 769 769 769 769 768 769 768 769 768 769 765 766 766 765  76  76  76  76  76
76  76  76  76  76 765 766 766 765 767 769 769 769 767 769 769 767 769 769 769 767 765 766 766 765  76  76  76  76  76
76  76  76  76  76 765 766 766 765 768 769 769 769 768 769 769 768 769 769 769 768 765 766 766 765  76  76  76  76  76
76  76  76  76  76 765 766 766 765 769 769 767 769 767 769 767 769 769 767 769 769 765 766 766 765  76  76  76  76  76
76  76  76  76  76 765 766 766 765 769 769 768 769 768 769 768 769 769 768 769 769 765 766 766 765  76  76  76  76  76
76  76  76  76  76 765 766 766 765 767 769 769 767 769 767 769 767 769 767 769 769 765 766 766 765  76  76  76  76  76
76  76  76  76  76 765 766 766 765 768 769 769 768 769 768 769 768 769 768 769 769 765 766 766 765  76  76  76  76  76
76  76  76  76  76 770 772 772 770 769 767 769 769 767 769 769 767 769 769 769 767 770 772 772 770  76  76  76  76  76
76  76  76  76  76 771 773 773 771 769 768 769 769 768 769 769 768 769 769 769 768 771 773 773 771  76  76  76  76  76
76  76  76  76  76 769 769 769 769 767 769 767 769 767 769 769 767 769 767 769 767 769 769 769 769  76  76  76  76  76
76  76  76  76  76 769 769 769 769 768 769 768 769 768 769 769 768 769 768 769 768 769 769 769 769  76  76  76  76  76
76  76  76  76  76 769 769 769 769 769 769 769 769 769 769 769 769 769 769 769 769 769 769 769 769  76  76  76  76  76
76  76  76  76  76 769 769 769 769 769 769 769 769 769 769 769 769 769 769 769 769 769 769 769 769  76  76  76  76  76
76  76  76  76  76 774   3 774   3 774   3 774   3 774   3 774   3 774   3 774   3 774   3 769 769  76  76  76  76  76
76  76  76  76  76 776 774   3 774   3 774   3 774   3 774   3 774   3 774   3 774   3 776 769 769  76  76  76  76  76
76  76  76  76  76 765 766 766 766 766 766 766 766 766 766 766 766 766 766 766 766 766 765 769 769  76  76  76  76  76
76  76  76  76  76 765 766 766 766 766 766 766 766 766 766 766 766 766 766 766 766 766 765 769 769  76  76  76  76  76
76  76  76  76  76 765 766 766 766 766 766 766 766 766 766 766 766 766 766 766 766 766 765 769 769  76  76  76  76  76
76  76  76  76  76 765 766 766 766 766 766 766 766 766 766 766 766 766 766 766 766 766 765 769 769  76  76  76  76  76
76  76  76  76  76 765 766 766 766 766 766 766 766 766 766 766 766 766 766 766 766 766 765 769 769  76  76  76  76  76
76  76  76  76  76 777 778 778 778 778 778 778 778 778 778 778 778 778 778 778 778 778 777 769 769  76  76  76  76  76
76  76  76  76  76 770 772 772 772 772 772 772 772 765 766 766 766 766 765 772 772 772 770 769 769  76  76  76  76  76
76  76  76  76  76 771 773 773 773 779 773 773 773 765 766 766 766 766 765 779 773 773 771 769 769  76  76  76  76  76
76  76  76  76  76 780 780 780 780 780 780 780 780 765 766 766 766 766 765 769 769 769 769 769 769  76  76  76  76  76
76  76  76  76  76 780 780 780 781 780 780 780 780 777 778 778 778 778 777 769 769 769 769 769 769  76  76  76  76  76
76  76  76  76  76 780 780 780 780 780 780 780 780 765 766 766 766 766 765 774   3 774   3 774   3  76  76  76  76  76
76  76  76  76  76 780 780 780 780 780 780 780 780 765 766 766 766 766 765   3 774   3 774   3 774  76  76  76  76  76
76  76  76  76  76 780 780 780 780 780 780 780 780 765 766 766 766 766 765 774   3 774   3 774   3  76  76  76  76  76
76  76  76  76  76 780 780 780 780 780 780 780 780 777 778 778 778 778 777   3 774   3 774   3 776  76  76  76  76  76
76  76  76  76  76 780 780 780 780 780 780 780 780 765 766 766 766 766 765 766 766 766 766 766 765  76  76  76  76  76
76  76  76  76  76 780 780 780 780 780 780 780 780 765 766 766 766 766 765 766 766 766 766 766 765  76  76  76  76  76
76  76  76  76  76 780 780 780 780 780 780 780 780 765 766 766 766 766 765 766 766 766 766 766 765  76  76  76  76  76
76  76  76  76  76 780 780 780 780 780 780 780 780 777 778 778 778 778 777 778 778 778 778 778 777  76  76  76  76  76
76  76  76  76  76  76 780 780 780 780  76 780 780 770 772 772 772 772 770 772 772 772 772 772 770  76  76  76  76  76
76  76  76  76  76 776 780 780 780 780 776 780 780 771 773 773 773 773 771 773 773 773 773 773 771  76  76  76  76  76
76  76  76  76  76 765 766 766 766 766 765 780 780 782 782   4   4 780 780 774   3 774   3 774   3  76  76  76  76  76
76  76  76  76  76 777 778 778 778 778 777 780 780 782 782   4   4 780 780   3 774   3 774   3 774  76  76  76  76  76
76  76  76  76  76 770 772 772 772 772 770 780 780 780 782 782 780 780 780 774   3 774   3 774   3  76  76  76  76  76
76  76  76  76  76 771 773 773 773 773 771 780 780 780 782 782 780 780 780 776 774   3 774   3 776  76  76  76  76  76
76  76  76  76  76 780 780 780 780 780 780 780 780 780 780 780 780 780 780 765 766 766 766 766 765  76  76  76  76  76
76  76  76  76  76 780 780 780 780 780 780 780 780 780 780 780 780 780 780 777 778 778 778 778 777  76  76  76  76  76
76  76  76  76  76  76 780 780 780 780  76 780 780 780 780 780  76 780 780 765 766 766 766 766 765  76  76  76  76  76
76  76  76  76  76 776 780 780 780 780 776 780 780 780 780 780 776 780 780 765 766 766 766 766 765  76  76  76  76  76
76  76  76  76  76 765 766 766 766 766 765 766 766 766 766 766 765 780 780 765 766 766 766 766 765  76  76  76  76  76
76  76  76  76  76 777 778 778 778 778 777 778 778 778 778 778 777 780 780 777 778 778 778 778 777  76  76  76  76  76
76  76  76  76  76 765 766 766 766 766 765 772 772 772 772 772 770 780 780 765 766 766 766 766 765  76  76  76  76  76
76  76  76  76  76 765 766 766 766 766 765 773 773 773 773 773 771 780 780 765 766 766 766 766 765  76  76  76  76  76
76  76  76  76  76 765 766 766 766 766 765   4   4   4   4 780 780 780 780 765 766 766 766 766 765  76  76  76  76  76
76  76  76  76  76 777 778 778 778 778 777   4   4   4   4 780 780 780 780 777 778 778 778 778 777  76  76  76  76  76
76  76  76  76  76 765 766 766 766 766 765   4   4 782 782 780 780 782 780 765 766 766 766 766 765  76  76  76  76  76
76  76  76  76  76 765 766 766 766 766 765   4   4 782 782 780 780 782 780 765 766 766 766 766 765  76  76  76  76  76
76  76  76  76  76 765 766 766 766 766 765 782 780 780 782   4   4   4   4 765 766 766 766 766 765  76  76  76  76  76
76  76  76  76  76 777 778 778 778 778 777 782 780 780 782   4   4   4   4 777 778 778 778 778 777  76  76  76  76  76
76  76  76  76  76 765 766 766 766 766 765 782 780 780 782 780 782 782 780 765 766 766 766 766 765  76  76  76  76  76
76  76  76  76  76 765 766 766 766 766 765 782 780 780 782 780 782 782 780 765 766 766 766 766 765  76  76  76  76  76
76  76  76  76  76 765 766 766 766 766 765   4   4 782 782 780 780 782 780 765 766 766 766 766 765  76  76  76  76  76
76  76  76  76  76 777 778 778 778 778 777   4   4 782 782 780 780 782 780 777 778 778 778 778 777  76  76  76  76  76
76  76  76  76  76 765 766 766 766 766 765 782 780   4   4 780 782 780 780 770 772 772 772 772 770  76  76  76  76  76
76  76  76  76  76 765 766 766 766 766 765 782 780   4   4 780 782 780 780 771 773 773 773 773 771  76  76  76  76  76
76  76  76  76  76 765 766 766 766 766 765 782 782 780 780 780 780 780 780   4   4   4   4   4   4  76  76  76  76  76
76  76  76  76  76 777 778 778 778 778 777 782 782 780 780 780 780 780 780   4   4   4   4   4   4  76  76  76  76  76
76  76  76  76  76 765 766 766 766 766 765 782 782 780 780 780 780 780 780  76 780 780 780 780  76  76  76  76  76  76
76  76  76  76  76 765 766 766 766 766 765 782 782 780 780 780 780 780 780 776 780 780 780 780 776  76  76  76  76  76
76  76  76  76  76 765 766 766 766 766 765  88  88  88  88  88  88  88  88 765 766 766 766 766 765  76  76  76  76  76
76  76  76  76  76 777 778 778 778 778 777  81  81  81  81  81  81  81  81 777 778 778 778 778 777  76  76  76  76  76
76  76  76  76  76 770 772 772 772 772 770  81  81  81  81  81  81  81  81 770 772 772 772 772 770  76  76  76  76  76
76  76  76  76  76 771 773 773 773 773 771  81  81  81  81  81  81  81  81 771 773 773 773 773 771  76  76  76  76  76
76  76  76  76  76  81  81  81  81  81  81  81  81  81  81  81  81  81  81  81  81  81  81  81  81  76  76  76  76  76
76  76  76  76  76  81  81  81  81  81  81  81  81  81  81  81  81  81  81  81  81  81  81  81  81  76  76  76  76  76
76  76  76  76  76  81  81  81  81  81  81  81  81  81  81  81  81  81  81  81  81  81  81  81  81  76  76  76  76  76
76  76  76  76  76  81  81  81  81  81  81  81  81 776  81  81  81  81  81 776  81  81  81  81 776  76  76  76  76  76
76  76  76  76  76  81  81  81  81  81  81  81  81 765 766 766 766 766 766 765 766 766 766 766 765  76  76  76  76  76
76  76  76  76  76  81  81  81  81  81  81  81  81 777 778 778 778 778 778 777 778 778 778 778 777  76  76  76  76  76
76  76  76  76  76  81  81  81  81  81  81  81  81 770 772 772 772 772 772 765 766 766 766 766 765  76  76  76  76  76
76  76  76  76  76 776  81  81 776  81  81  81  81 771 773 773 773 773 773 765 766 766 766 766 765  76  76  76  76  76
76  76  76  76  76 765 766 766 765  81  81  81  81  81  81  81  81  81  81 765 766 766 766 766 765  76  76  76  76  76
76  76  76  76  76 777 778 778 777  81  81  81  81  81  81  81  81  81  81 777 778 778 778 778 777  76  76  76  76  76
76  76  76  76  76 765 766 766 765  81  81  81  81  81  81  81  81  81  81 765 766 766 766 766 765  76  76  76  76  76
76  76  76  76  76 765 766 766 765  81  81  81  81  81  81  81  81  81  81 765 766 766 766 766 765  76  76  76  76  76
76  76  76  76  76 765 766 766 765  81  81  81  81  81  81  81  81  81  81 765 766 766 766 766 765  76  76  76  76  76
76  76  76  76  76 777 778 778 777  81  81  81  81  81  81  81  81  81  81 777 778 778 778 778 777  76  76  76  76  76
76  76  76  76  76 770 772 772 770  81  81  81  89 780 780  90  81  81  81 765 766 766 766 766 765  76  76  76  76  76
76  76  76  76  76 771 773 773 771  81  81  81  89 780 780  90  81  81  81 765 766 766 766 766 765  76  76  76  76  76
76  76  76  76  76  81  81  81  81  81  81  81  87  88  88  86  81  81  81 765 766 766 766 766 765  76  76  76  76  76
76  76  76  76  76  81  81  81  81  81  81  81  81  81  81  81  81  81  81 777 778 778 778 778 777  76  76  76  76  76
76  76  76  76  76  81  81  81  81  81  81  81  81  81  81  81  81  81  81 765 766 766 766 766 765  76  76  76  76  76
76  76  76  76  76 776  81  81  81  81  81  81 776  81  81  81  81  81  81 765 766 766 766 766 765  76  76  76  76  76
76  76  76  76  76 765 766 766 766 766 766 766 765  81  81  81  81  81  81 765 766 766 766 766 765  76  76  76  76  76
76  76  76  76  76 777 778 778 778 778 778 778 777  81  81  81  81  81  81 777 778 778 778 778 777  76  76  76  76  76
76  76  76  76  76 770 772 772 772 772 772 772 770  81  81  81  81  81  81 770 772 772 772 772 770  76  76  76  76  76
76  76  76  76  76 771 773 773 773 773 773 773 771  81  81  81  81  81  81 771 773 773 773 773 771  76  76  76  76  76
76  76  76  76  76  81  81  81  81  81  81  81  81  81  81  81  81  81  81  81  81  81  81  81  81  76  76  76  76  76
76  76  76  76  76  81  81  81  81  81  81  81  81  81  81  81  81  81  81  81  81  81  81  81  81  76  76  76  76  76
76  76  76  76  76  81  81  81  81  81  81  81  81  81  81  81  81  81  81  81  81  81  81  81  81  76  76  76  76  76
76  76  76  76  76 776  81  81  81  81  81  81  81  81 776  81  81  81  81  81  81 776  81  81 776  76  76  76  76  76
76  76  76  76  76 765 766 766 766 766 766 766 766 766 765 780 780 780 780 780 780 765 766 766 765  76  76  76  76  76
76  76  76  76  76 777 778 778 778 778 778 778 778 778 777 780 780 780 780 780 780 777 778 778 777  76  76  76  76  76
76  76  76  76  76 770 772 772 772 772 772 772 772 772 770 780 780 780 780 780 780 770 772 772 770  76  76  76  76  76
76  76  76  76  76 771 773 773 773 773 773 773 773 773 771 780 780 780 780 780 780 771 773 773 771  76  76  76  76  76
76  76  76  76  76 769 769 769 769 769 769 769 769 769 769 769 769 769 769 769 769 774   3 774   3  76  76  76  76  76
76  76  76  76  76 769 769 769 769 769 769 769 769 769 769 769 769 769 769 769 769   3 774   3 774  76  76  76  76  76
76  76  76  76  76 769 769 774   3 774   3 774   3 774   3 774   3 774   3 774   3 774   3 774   3  76  76  76  76  76
76  76  76  76  76 769 769 776 774   3 774   3 774   3 776   3 774 776 774   3 774   3 774   3 776  76  76  76  76  76
76  76  76  76  76 769 769 765 766 766 766 766 766 766 765 774   3 765 766 766 766 766 766 766 765  76  76  76  76  76
76  76  76  76  76 769 769 777 778 778 778 778 778 778 777   3 774 777 778 778 778 778 778 778 777  76  76  76  76  76
76  76  76  76  76 769 769 770 772 772 772 772 772 772 770 774   3 770 772 772 772 772 772 772 770  76  76  76  76  76
76  76  76  76  76 769 769 771 773 773 773 773 773 773 771   3 774 771 773 773 773 773 773 773 771  76  76  76  76  76
76  76  76  76  76 769 769 769 769 769 769 769 769 769 769 774   3 774   3 774   3 774   3 774   3  76  76  76  76  76
76  76  76  76  76 769 769 769 769 769 769 769 769 769 769   3 774   3 774   3 774   3 774   3 774  76  76  76  76  76
76  76  76  76  76 774   3 774   3 774   3 774   3 769 769 774   3 774   3 774   3 774   3 774   3  76  76  76  76  76
76  76  76  76  76 776 774   3 774   3 774   3 776 769 769 776 774   3 774   3 776   3 774   3 776  76  76  76  76  76
76  76  76  76  76 765 766 766 766 766 766 766 765 769 769 765 766 766 766 766 765 766 766 766 765  76  76  76  76  76
76  76  76  76  76 777 778 778 778 778 778 778 777 769 769 777 778 778 778 778 777 778 778 778 777  76  76  76  76  76
76  76  76  76  76 770 772 772 772 772 772 772 770 769 769 770 772 772 772 772 770 772 772 772 770  76  76  76  76  76
76  76  76  76  76 771 773 773 773 773 773 773 771 769 769 771 773 773 773 773 771 773 773 773 771  76  76  76  76  76
76  76  76  76  76 774   3 774   3 774   3 774   3 769 769 769 769 769 769 769 769 769 769 769 769  76  76  76  76  76
76  76  76  76  76   3 774   3 774   3 774   3 774 769 769 769 769 769 769 769 769 769 769 769 769  76  76  76  76  76
76  76  76  76  76 774   3 774   3 774   3 774   3 774   3 774   3 774   3 769 769 774   3 774   3  76  76  76  76  76
76  76  76  76  76 776 774   3 774 776 774   3 774   3 776   3 774   3 776 769 769 776 774   3 776  76  76  76  76  76
76  76  76  76  76 765 766 766 766 765 766 766 766 766 765 766 766 766 765 769 769 765 766 766 765  76  76  76  76  76
76  76  76  76  76 777 778 778 778 777 778 778 778 778 777 778 778 778 777 769 769 777 778 778 777  76  76  76  76  76
76  76  76  76  76 770 772 772 772 770 772 772 772 772 770 772 772 772 770 769 769 770 772 772 770  76  76  76  76  76
76  76  76  76  76 771 773 773 773 771 773 773 773 773 771 773 773 773 771 769 769 771 773 773 771  76  76  76  76  76
76  76  76  76  76 774   3 774   3 774   3 769 769 769 769 769 769 769 769 769 769 769 769 769 769  76  76  76  76  76
76  76  76  76  76   3 774   3 774   3 774 769 769 769 769 769 769 769 769 769 769 769 769 769 769  76  76  76  76  76
76  76  76  76  76 774   3 774   3 774   3 769 769 769 769 774   3 774   3 774   3 774   3 774   3  76  76  76  76  76
76  76  76  76  76 776 774   3 774   3 776 769 769 769 769 776 774   3 774   3 774   3 774   3 776  76  76  76  76  76
76  76  76  76  76 765 766 766 766 766 765 769 769 769 769 765 766 766 766 766 766 766 766 766 765  76  76  76  76  76
76  76  76  76  76 777 778 778 778 778 777 769 769 769 769 777 778 778 778 778 778 778 778 778 777  76  76  76  76  76
76  76  76  76  76 770 772 772 772 772 770 769 769 769 769 770 772 772 772 772 772 772 772 772 770  76  76  76  76  76
76  76  76  76  76 771 773 773 773 773 771 769 769 769 769 771 773 773 773 773 773 773 773 773 771  76  76  76  76  76
76  76  76  76  76 774   3 102  71  71  71  71 168 168  71  71  71  71 103 774   3 774   3 774   3  76  76  76  76  76
76  76  76  76  76   3 774 104  68  68  68  68  68  68  68  68  68  68 105   3 774   3 774   3 774  76  76  76  76  76
76  76  76  76  76 774   3 108  65  65  65  65  65  65  65  65  65  65 109 774   3 774   3 774   3  76  76  76  76  76
76  76  76  76  76   3 774 108  65  65  65  65  65  65  65  65  65  65 109   3 774   3 774   3 774  76  76  76  76  76
76  76  76  76  76 774   3 108  65  65  65  65  65  65  65  65  65  65 109 774   3 774   3 774   3  76  76  76  76  76