NAME
Route 18
NPCS
route18-sign1 blank 15 0
INTERACTIONS
MENU:ALERT:CYCLING ROAD {NEWLINE} Slope ends here!
END
route18-sign2 blank 40 8
INTERACTIONS
MENU:ALERT:CYCLING ROAD {NEWLINE} No pedestrians permitted!|MENU:ALERT:TODO: IMPLEMENT THIS
END
route18-sign3 blank 50 10
INTERACTIONS
MENU:ALERT:ROUTE 18 {NEWLINE} CELADON CITY - FUCHSIA CITY
END
route18-guy1 guy2 43 14 RIGHT
FORCE_INTERACTION
1 0
2 0
3 0
END
INTERACTIONS
!:route18-guy1|MOVE_TO_PLAYER|MENU:ALERT:I always check every grassy area for new POK{e-accent}MON.|BATTLE:route18-guy1|{NO_ADVANCE}{DISABLE_FORCE}
MENU:ALERT:I wish I had a BIKE!
END
route18-guy2 guy2 49 16 LEFT
FORCE_INTERACTION
-1 0
-2 0
-3 0
END
INTERACTIONS
!:route18-guy2|MOVE_TO_PLAYER|MENU:ALERT:This is my turf! Get out of here!|BATTLE:route18-guy2|{NO_ADVANCE}{DISABLE_FORCE}
MENU:ALERT:This is my fave POK{e-accent}MON hunting area!
END
route18-guy3 guy2 47 18 LEFT
FORCE_INTERACTION
-1 0
-2 0
-3 0
END
INTERACTIONS
!:route18-guy3|MOVE_TO_PLAYER|MENU:ALERT:Kurukkoo! {NEWLINE} How do you like my bird call?|BATTLE:route18-guy3|{NO_ADVANCE}{DISABLE_FORCE}
MENU:ALERT:I also collect sea POK{e-accent}MON on weekends!
END
TRAINERS
route18-guy1 25 0.6 0.6 BIRD{SPACE}KEEPER birdkeeper.png {BIRD{SPACE}KEEPER: Tch!}{} 22-15:44|22-12:44
route18-guy2 25 0.6 0.6 BIRD{SPACE}KEEPER birdkeeper.png {BIRD{SPACE}KEEPER: Darn!}{} 22-122:42|101-22:42|22-80:42|44-22:42
route18-guy3 25 0.6 0.6 BIRD{SPACE}KEEPER birdkeeper.png {BIRD{SPACE}KEEPER: I had to bug you!}{} 85-85:46
END
TELEPORT
7 0 route17 7 141
8 0 route17 8 141
9 0 route17 9 141
10 0 route17 10 141
11 0 route17 11 141
12 0 route17 12 141
13 0 route17 13 141
14 0 route17 14 141
16 0 route17 16 141
17 0 route17 17 141
18 0 route17 18 141
19 0 route17 19 141
20 0 route17 20 141
21 0 route17 21 141
22 0 route17 22 141
23 0 route17 23 141
24 0 route17 24 141
41 11 route18-checkpoint 1 4
41 12 route18-checkpoint 1 5
46 11 route18-checkpoint 8 4
46 12 route18-checkpoint 8 5
57 11 fuchsia-city 5 19
57 12 fuchsia-city 5 20
NEIGHBORS
route17 0 -141
fuchsia-city 52 -8
ENCOUNTERS
20 22 25 77 84 128
WATER_ENCOUNTERS_OLD
129
WATER_ENCOUNTERS_GOOD
60 118
WATER_ENCOUNTERS_SUPER
73 90 98 119
LEVELS
33-39
DATA
81  81  81  81  81  81 656  81  81  81  81  89 295 296  56   5  56  56 295 296  90  81  81  81  81 656  81  81  81  89  56  56  56  56  56  56  56  56  56  56  56  56  56  56  56  56  56  56  56  56  56  56  56  56  56  56  56  76
81  81  81  81  81  81 656  81  81  81  81  89  56  56  56  56  56  56  56  56  90  81  81  81  81 656  81  81  81  89  56  56  56  56  56  56  56  56  56  56  56  56  56  56  56  56  56  56  56  56  56  56  56  56  56  56  56  76
81  81  81  81  81  81 656  81  81  81  81  89  78  78  78  78  80  78  78  78  90  81  81  81  81 656  81  81  81  89  56  56  56  56  56  56  56  56  56  56  56  56  56  56  56  56  56  56  56  56  56  56  56  56  56  56  56  76
81  81  81  81  81  81 656  81  81  81  81  89  56  56  56  56  56  56  56  56  90  81  81  81  81  81 656  81  81  89  56  56  56  56  56  56  56  56  56  56  56  56  56  56  56  56  56  56  56  56  56  56  56  56  56  56  56  76
81  81  81  81  81  81 656  81  81  81  81  89  56  56  56  56  56  56  56  56  90  81  81  81  81  81 656 656 656 656   0  56  56  56  56  56  56  56  56  56  56  56  56  56  56  56  56  56  56  56  56  56  56  56  56  56  56  76
81  81  81  81  81  81 656  81  81  81  81  89  56  56  93  93  93  93  56  56  90  81  81  81  81  81  81  81  81  89   0  56  56  56  56  56  56  56  56  56  56  56  56  56  56  56  56  56  56  56  56  56  56  56  56  56  56  76
81  81  81  81  81  81 656  81  81  81  81  89  56  56  94  94  94  94  56  56  90  81  81  81  81  81  81  81  81  89   0  56  56  56  56  56  56  56  56  56  56  56  56  56  56  56  56  56  56  56  56  56  56  56  56  56  56  76
81  81  81  81  81  81 656  81  81  81  81  89  56  56  93  93  93  93  56  56  90  81  81  81  81  81  81  81  81  89   0  56  56  56  56  56  56  56  56  56  56 102  71  71  71  71 103  56  56  56  56  56  56  56  56  56  56  76
81  81  81  81  81  81 656  81  81  81  81  89  56  56  94  94  94  94  56  56  90  81  81  81  81  81  81  81  81  89   0  55  55  55  55  55  55  55  55  55   5 104  68  68  68  68 105  56  56  56  56  56  56  56  56  56  56  76
81  81  81  81  81  81 656  81  81  81  81  89  56  56  93  93  93  93  56  56  93  93  93  93  93  93  93  93  93  93  93  93  93  93  93  93  93  93  93  93  93 108  65  65  65  65 109  56  56  56  56  56  56  56  56  56  56  76
81  81  81  81  81  81 656  81  81  81  81  89  56  56  94  94  94  94  56  56  94  94  94  94  94  94  94  94  94  94  94  94  94  94  94  94  94  94  94  94  94 108  65  65  65  65 109  55  55  55   5  55  55  55  55  55  55  76
81  81  81  81  81  81 656  81  81  81  81  89  56  56  56  56  56  56  56  56  56  56  56  56  56  56  56  56  56  56  56  56  56  56  56  56  56  56  56  56  56 453  65  65  65  65 455   2   3   2   3   2   3   2   3   2   3   2
81  81  81  81  81  81 656  81  81  81  81  89  56  56  56  56  56  56  56  56  56  56  56  56  56  56  56  56  56  56  56  56  56  56  56  56  56  56  56  56  56 454 164 164 164 164 456   3   2   3   2   3   2   3   2   3   2   3
81  81  81  81  81  81 656  81  81  81  81  87  88  88  88  88  88  88  88  88  88  88  88  88  88  88  88  88  88  88  88  88  88  88  88  88  88  88  88  88  88   0   0   0   0   0   0   0   1   1   0   0   0   0   0   0   0   0
81  81  81  81  81  81 656  81  81  81  81  81  81  81  81  81  81  81  81  81  81  81  81  81  81  81  81  81  81  81  81  81  81  81  81  81  81  81  81  81  81   0   1   1   1   1   1   1   1   1   0   1   1   1   1   1   0   0
81  81  81  81  81  81 656  81  81  81  81  81  81  81  81  81  81  81  81  81  81  81  81  81  81  81  81  81  81  81  81  81  81  81  81  81  81  81  81  81  81   0   1   4   4   4   4   4   4   1   0  93  93  93  93   1   0   0
81  81  81  81  81  81 656  81  81  81  81  81  81  81  81  81  81  81  81  81  81  81  81  81  81  81  81  81  81  81  81  81  81  81  81  81  81  81  81  81  81   0   1   4   4   4   4   4   4   1   0  94  94  94  94   1   0   0
81  81  81  81  81  81 656  81  81  81  81  81  81  81  81  81  81  81  81  81  81  81  81  81  81  81  81  81  81  81  81  81  81  81  81  81  81  81  81  81  81   0   1   4   4   4   4   4   4   1   0  93  93  93  93   1   0   0
81  81  81  81  81  81 656  81  81  81  81  81  81  81  81  81  81  81  81  81  81  81  81  81  81  81  81  81  81  81  81  81  81  81  81  81  81  81  81  81  81   0   1   4   4   4   4   4   4   1   0  94  94  94  94   1   0   0
81  81  81  81  81  81 656  81  81  81  81  81  81  81  81  81  81  81  81  81  81  81  81  81  81  81  81  81  81  81  81  81  81  81  81  81  81  81  81  81  81   0   1   1   1   1   1   1   1   1   0   1   1   1   1   1   0   0
81  81  81  81  81  81 656 656 656 656 656 656 656 656 656 656 656 656 656 656 656 656 656 656 656 656 656 656 656 656 656 656 656 656 656 656 656 656 656 656 656   0   0   0   0   0   0   0   0   0   0   0   0   0   0   0   0   0
81  81  81  81  81  81  81  81  81  81  81  81  81  81  81  81  81  81  81  81  81  81  81  81  81  81  81  81  81  81  81  81  81  81  81  81  81  81  81  81  81  81  81  81  81  81  81  81  81  81  81  81  81  81  81  81  81   0
81  81  81  81  81  81  81  81  81  81  81  81  81  81  81  81  81  81  81  81  81  81  81  81  81  81  81  81  81  81  81  81  81  81  81  81  81  81  81  81  81  81  81  81  81  81  81  81  81  81  81  81  81  81  81  81  81   0
81  81  81  81  81  81  81  81  81  81  81  81  81  81  81  81  81  81  81  81  81  81  81  81  81  81  81  81  81  81  81  81  81  81  81  81  81  81  81  81  81  81  81  81  81  81  81  81  81  81  81  81  81  81  81  81  81   0
81  81  81  81  81  81  81  81  81  81  81  81  81  81  81  81  81  81  81  81  81  81  81  81  81  81  81  81  81  81  81  81  81  81  81  81  81  81  81  81  81  81  81  81  81  81  81  81  81  81  81  81  81  81  81  81  81   0
81  81  81  81  81  81  81  81  81  81  81  81  81  81  81  81  81  81  81  81  81  81  81  81  81  81  81  81  81  81  81  81  81  81  81  81  81  81  81  81  81  81  81  81  81  81  81  81  81  81  81  81  81  81  81  81  81   0