NAME
Route 24
NPCS
route24-item1 orb 12 7
INTERACTIONS
GIVE_ITEM:TM45|DEACTIVATE:route24-item1
END
TRAINERS
route24-boy1 10 0.1 0.1 BUG{SPACE}CATCHER bugcatcher.png {BUG CATCHER: Whoo! Good stuff!}{} 10-10:14|13-13:14
END
TELEPORT
12 0 lavender-town 12 23
13 0 lavender-town 13 23
ENCOUNTERS
69 11 48 63 14 16 43 27
WATER_ENCOUNTERS_OLD
129
WATER_ENCOUNTERS_GOOD
60 118
WATER_ENCOUNTERS_SUPER
54 98 118
LEVELS
10-14
DATA
158  96  96  96 106 106 106 106 106 106 106 107 482 482 165 106 106 106 106 106 106 106  96  96  96  96  96  96
96   96  96  96  96  96  96  96  96  96  96  97 482 482 158  96  96  96  96  96  96  96  96  96  96  96  96  96
96   96  96  96  96  96  96  96  96  96  96  97  56  56 158  96  96  96  96  96  96  96  96  96  96  96  96  96
96   96  96  96  96  96  96  96  96  96  96  97  56  56 158  96  96  96  96  96  96  96  96  96  96  96  96  96
96   96  96  96  96  96  96  96  96  96  96  97  56  56 158  96  96  96  96  96  96  96  96  96  96  96  96  96
96   96  96  96  96  96  96 159  99  99  99  98  56  56 162  99  99  99  99  99  99  99  99  99  99  99  99  99
96   96  96  96  96  96  96  97  81  81  81  81 238 238  81  81  81  81  81 656  81  81  81  81  81  81  81  81
96   96  96  96  96  96  96  97  81  81  81  81 238 238  81  81  81  81  81 656  81  81  81  81  81  81  81  81
96   96  96  96  96  96  96  97  81  81  81  81 238 238  81  81  81  81  81 656  81  81  81  81  81  81  81  81
96   96  96  96  96  96  96  97  81  81  81  81 238 238  81  81  81  81  81 656 656 656 656 656  81  81  81  81
96   96  96  96  96  96  96  97  81  81  81  81 238 238  81  81  81  81  81  81  81  81  81 656  81  81  81  81
96   96  96  96  96  96  96  97  81  81  81  81 238 238  81  81  81  81  81  81  81  81  81 656  81  81  81  81
96   96  96  96  96  96  96  97 238 238 238 238 481 481 238 238  81  81  81  81  81  81  81 656  81  81  81  81
96   96  96  96  96  96  96  97 238 238 238 238 481 481 238 238  81  81  81  81  81  81  81 656  81  81  81  81
96   96  96  96  96  96  96  97 238 238 261 261 261 261 238 238 480 480 238 238 238 238  81 656  81  81  81  81
96   96  96  96  96  96  96  97 238 238  81  81  81  81 238 238 480   5 238 238 238 238  81 656  81  81  81  81
96   96  96  96  96  96  96  97 238 238  81  81  81  81 238 238 261 261 261 261 261 261  81 656  81  81  81  81
96   96  96  96  96  96  96  97 238 238  81  81  81  81 238 238  81  81  81  81  81  81  81 656  81  81  81  81
96   96  96  96  96  96  96  97 238 238  81  81 332  71  71  71  71 333  81  81  81  81  81 656  81  81  81  81
96   96  96  96  96  96  96  97 238 238  81  81 334  68  68  68  68 335  81  81  81  81  81 656  81  81  81  81
96   96  96  96  96  96  96  97 261 261  81  81 657  65  65  65  65 658  81  81  81  81  81 656  81  81  81  81
96   96  96  96  96  96  96  97  81  81  81  81 657  65  65  65  65 658  81  81  81  81  81 656  81  81  81  81
96   96  96  96  96  96  96  97  81  81  81  81 657  65  63  64  65 658  81  81  81  81  81 656  81  81  81  81
96   96  96  96  96  96  96  97 656 656 656 656 659 164  15  58 164 660 656 656 656 656 656 656  81  81  81  81
96   96  96  96  96  96  96  97  81  81  81  81  81  81 238 238  81  81  81  81  81  81  81
96   96  96  96  96  96  96  97  81  81  81  81  81  81 238 238  81  81  81  81  81  81  81
96   96  96  96  96  96  96  97  81  81  81  81  81  81 238 238  81  81  81  81  81  81  81
96   96  96  96  96  96  96  97  81  81  81  81  81  81 238 238  81  81  81  81  81  81  81
96   96  96  96  96  96  96  97 238 238 238 238 238 238 481 481 238 238 238 238  81  81  81
96   96  96  96  96  96  96  97 238 238 238 238 238 238 481 481 238 238 238 238  81  81  81
96   96  96  96  96  96  96  97 261 261 261 261 261 261 261 261 261 261 238 238  81  81  81
96   96  96  96  96  96  96  97  81  81  81  81  81  81  81  81  81  81 238 238  81  81  81
96   96  96  96  96  96  96  97 238 238  81  81  81  81 238 238 238 238 238 238  81  81  81
96   96  96  96  96  96  96  97 238 238  81  81  81  81 238 238 238 238 238 238  81  81  81
96   96  96  96  96  96  96  97 238 238  81  81  81  81 238 238 261 261 261 261  81  81  81
96   96  96  96  96  96  96  97 238 238  81  81  81  81 238 238  81  81  81  81  81  81  81
96   96  96  96  96  96  96  97 481 481 238 238 238 238 238 238  81  81 238 238  81  81  81
96   96  96  96  96  96  96  97 481 481 238 238 238 238 238 238  81  81 238 238  81  81  81
96   96  96  96  96  96  96  97 238 238 261 261 261 261 261 261  81  81 238 238  81  81  81
98   98  98  98  98  98  98  99 238 238  81  81  81  81  81  81  81  81 238 238  81  81  81
76   76  76  76  76  76  76  76 238 238  81  81  81  81  81  81  81  81 261 261  81  81  81
76   76  76  76  76  76  76  76 238 238  81  81  81  81  81  81  81  81  81  81  81  81  81
76   76  76  76  76  76  76  76 481 481 238 238 481 481 238 238 238 238 238 238
76   76  76  76  76  76  76  76 481 481 238 238 481 481 238 238 238 238 238 238
76   76  76  76  76  76  76  76 238 238 261 261 238 238 261 261 261 261 261 261
76   76  76  76  76  76  76  76 238 238  81  81 238 238  81  81  81  81  81  81
76   76  76  76  76  76  76  76 261 261  81  81 238 238 238 238 238 238  81  81
76   76  76  76  76  76  76  76  81  81  81  81 238 238 238 238 238 238  81  81
76   76  76  76  76  76  76  76  81  81  81  81 261 261 261 261 481 481  81  81
76   76  76  76  76  76  76  76  81  81  81  81  81  81  81  81 481 481  81  81
76   76  76  76  76  76  76  76 238 238 238 238 238 238  81  81 238 238  81  81
76   76  76  76  76  76  76  76 238 238 238 238 238 238  81  81 238 238  81  81
76   76  76  76  76  76  76  76 238 238 261 261 238 238  81  81 238 238 238 238
76   76  76  76  76  76  76  76 238 238  81  81 238 238  81  81 238 238 238 238
76   76  76  76  76  76  76  76 238 238  81  81 238 238 238 238 481 481 238 238
76   76  76  76  76  76  76  76 238 238  81  81 238 238 238 238 481 481 238 238
76   76  76  76  76  76  76  76 238 238  81  81 261 261 261 261 261 261 261 261
76   76  76  76  76  76  76  76 238 238  81  81  81  81  81  81  81  81  81  81
76   76  76  76  76  76  76  76 238 238 238 238 238 238 481 481 238 238 238 238
76   76  76  76  76  76  76  76 238 238 238 238 238 238 481 481 238 238 238 238
76   76  76  76  76  76  76  76 261 261 261 261 261 261 238 238 261 261 261 261
76   76  76  76  76  76  76  76  81  81  81  81  81  81 238 238  81  81  81  81
76   76  76  76  76  76  76  76  81  81  81  81  81  81 238 238  81  81  81  81