NAME
Route 4
NPCS
route4-girl girl 10 18
INTERACTIONS
MENU:ALERT:Ouch! I tripped over a rocky POK{e-accent}MON, GEODUDE!
END
route4-sign blank 19 17
INTERACTIONS
MENU:ALERT:MT. MOON{NEWLINE}Tunnel Entrance
END
route4-sign2 blank 32 17
INTERACTIONS
MENU:ALERT:TODO: Fix this sign
END
route4-item orb 62 13
INTERACTIONS
GIVE_ITEM:TM04|DEACTIVATE:route4-item
END
TELEPORT
9 29 route3 57 2
10 29 route3 58 2
11 29 route3 59 2
12 29 route3 60 2
13 29 route3 61 2
14 29 route3 62 2
15 29 route3 63 2
13 15 route4-center 3 7
20 15 mt-moon 14 35
29 15 mt-moon 7 155
94 20 cerulean-city 1 20
94 21 cerulean-city 1 21
ENCOUNTERS
19 21 23 27 35 39 56 74
WATER_ENCOUNTERS_OLD
129
WATER_ENCOUNTERS_GOOD
60 118
WATER_ENCOUNTERS_SUPER
54 98 118 119
LEVELS
6-12
DATA
96
96
96
96
96
96
96
96   96  96  96  96  96  96  96  96  96  96  96  96  96  96  96  96  96  96  96  96  96  96  96  96  96  96  96  96  96  96  96  96  96  96  96  96  96  96  96  96  96  96  96  96  96  96  96  96  96  96  96  96  96  96  96  96  96  96  96  96  96  96  96  96  96  96  96  96  96  96  96  96  96  96  96  96  96  96  96  96  96  96  96  96  96  96  96  96  96  96  96  96  96  96
96   96  96  96  96  96  96  96  96  96  96  96  96  96  96  96  96  96  96  96  96  96  96  96  96  96  96  96  96  96  96  96  96  96  96  96  96  96  96  96  96  96  96  96  96  96  96  96  96  96  96  96  96  96  96  96  96  96  96  96  96  96  96  96  96  96  96  96  96  96  96  96  96  96  96  96  96  96  96  96  96  96  96  96  96  96  96  96  96  96  96  96  96  96  96
96   96  96  96  96  96  96  96  96  96  96  96  96  96  96  96  96  96  96  96  96  96  96  96  96  96  96  96  96  96  96  96  96  96  96  96  96  96  96  96  96  96  96  96  96  96  96  96  96  96  96  96  96  96  96  96  96  96  96  96  96  96  96  96  96  96  96  96  96  96  96  96  96  96  96  96  96  96  96  96  96  96  96  96  96  96  96  96  96  96  96  96  96  96  96
96   96  96  96  96  96  96  96  96  96  96  96  96  96  96  96  96  96  96  96  96  96  96  96  96  96  96  96  96  96  96  96  96  96  96  96  96  96  96  96  96  96  96  96  96  96  96  96  96  96  96  96  96  96  96  96  96  96  96  96  96  96  96  96  96  96  96  96  96  96  96  96  96  96  96  96  96  96  96  96  96  96  96  96  96  96  96  96  96  96  96  96  96  96  96
96   96  96  96  96  96  96  96  96  96  96 159  99  99  99  99 160  96  96  96  96  96  96  96  96  96  96  96  96  96  96  96  96  96  96  96  96  96  96  96 159  99  99  99  99  99  99  99  99  99  99  99  99  99  99  99  99  99  99  99  99  99  99  99  99  99  99  99  99  99  99  99  99  99  99  99  99  99  99  99  99  99  99  99  99 160  96  96  96  96  96  96  96  96  96
96   96  96  96  96  96  96  96  96  96  96  97 102  71  71 103 158  96  96  96  96  96  96  96  96  96  96  96  96  96  96  96  96  96  96  96  96  96  96  96  97   1   1 234   1   1   1   1 235   1 235   1   1   1   1 234   1   1   1 234   1   1   1   1   1 234   1   1   1   1   1   1   1   1   1   1   1  56  56  56  56  56  56  56  56 158  96  96  96  96  96  96  96  96  96
96   96  96  96  96 159  99  99  99  99  99  98 104  68  68 105 162  99 160  96  96  96  96  96  96  96  96  96  96  96  96  96  96  96  96  96  96  96  96  96  97   1   1 234   1   1   1   1 235   1 235   1   1   1   1 234   1   1   1 234   1   1   1   1   1 234   1   1   1   1   1   1   1   1   1   1   1  56  56  56  56  56  56  56  56 158  99  99  99  99  99  99  99  99  99
96   96  96  96  96  97   2   3   2   3   2   3 108  65  65 109   2   3 158  96  96  96  96  96  96  96  96  96  96  96  96  96  96  96  96  96  96  96  96  96  97   1   1 234   1   1   1   1 235   1 235   1   1   1   1 234   1   1   1 234   1   1   1   1   1 234   1   1   1   1   1   1   1   1   1   1   1  56  56  56  56  56  56  56  56  56  56  56  56  56  56  56  56  56  56
96   96  96  96  96  97   3   2   3   2   3   2 110  15 113 112   3   2 162  99 167  99 160  96  96  96  96  96 159 167  99  99  99  99  99  99  99  99  99  99  98   1   1 236  77  77  79  77 237   1 235   1   1   1   1 234   1   1   1 234   1   1   1   1   1 236  77  77  77  77  77  77  77  77  77  77  77  78  78  78  78  78  78  78  78   0   0   0   0   0   0   0   0   0   0
96   96  96  96  96  97  56  56  56  56   2   3   2   3   2   3   2   3  56  56   2   3 158  96  96  96  96  96  97  56  56  56  56  56  56   1   1   1   1   1   1   1   1   1   1   1   1   1   1   1 235   1   1   1   1 234   1   1   1 234   1   1   1   1   1   1   1   1   1   1   1   1   1   1   1   1   1  56  56  56  56  56  56  56  56   0  88  88  88  88  88  88  88  88  88
96   96  96  96  96  97  78  78  78  78   3   2   3   2   3   2   3   2  56   5   3   2 158  96  96  96  96  96  97  56  56  56   5  56  56   1   1   1   1   1   1   1   1   1   1   1   1   1   1   1 235   1   1   1   1 234   1   1   1 236  77  77  79  77  77  77  77  77  77  77  77  77  77  77  77  77  77  78  78  78  78  78  78  78  78   0  81  81  81  81  81  81  81  81  81
96   96  96  96  96  97   2   3   2   3   2   3   2   3   2   3  56  56  56  56  56  56 158  96  96  96  96  96  97   1   1   1   1   1   1   1   1   1   1   1   1   1   1   1   1   1   1   1   1   1 235   1   1   1   1 234   1   1   1   1   1   1   1   1   1   1   1   1   1   1   1   1   1   1   1   1   1  56  56   2   3  56  56  56  56   0  81  81  81  81  81  81  81  81  81
96   96  96  96  96  97   3   2   3   2   3   2   3   2   3   2  78  78  78  78  78  78 158  96  96  96  96  96  97  77  77  77  77  77  77  77  77  77  77  77  79  77  77  77  77  77  77  77  77  77 237   1   1   1   1 236  77  77  77  77  77  77  77  77  77  77  79  76  76  77  77  77  77  77  77  77  77  78  78  76  76  78  78  78  78   0   0   0   0   0   0   0   0   0   0
96   96  96  96  96  97  56  56  56  56  56  56  56  56   2   3   2   3   2   3   2   3 158  96  96  96  96  96  97   1   1   1   1   1   1   1   1   1   1   1   1   1   1   1   1   1   1   1   1   1   1   1   1   1   1   1   1   1   1   1   1   1   1   1   1   1   1  76   1   4   4   4   4   4   4   4   4   4   4   1  76  56  56  56  56  56  56  56  56  56  56  56  56  56  56
96   96  96  96  96  97  78  78  78  78  78  78  78  78   3   2   3   2   3   2   3   2 158  96  96  96  96  96  97   1   1   1   1   1   1   1   1   1   1   1   1   1   1   1   1   1   1   1   1   1   1   1   1   1   1   1   1   1   1   1   1   1   1   1   1   1   1  76   1   4   4   4   4   4   4   4   4   4   4   1  76  56  56  56  56  56  56  56  56  56  56  56  56  56  56
96   96  96  96  96  97   2   3   2   3   2   3   2   3   2   3  56  56  56  56  56  56 158  96  96  96  96  96  96 106 106 106 106 106 106 106 106 106 106 106 106 106 106 106 106 106 107   1   1   1   1   1   1   1   1   1   1   1   1   1   1   1   1   1   1   1   1  76   1   4   4   4   4   4   4   4   4   4   4   1  76   1   1   1   1   0   0   0   0   0   0   0   0   0   0
96   96  96  96  96  97   3   2   3   2   3   2   3   2   3   2  78  78  78  78  78  78 158  96  96  96  96  96  96  96  96  96  96  96  96  96  96  96  96  96  96  96  96  96  96  96  97  77  79  77  77  77  77  77  77  77  77  77  79  77  77  77  77  77  77  77  77  76   1   4   4   4   4   4   4   4   4   4   4   1  76  77  79  77  77   0   1   1   1   1   1   1   1   1   1
96   96  96  96  96  96 106 107  56  56  56  56   2   3   2   3   2   3   2   3   2   3 158  96  96  96  96  96  96  96  96  96  96  96  96  96  96  96  96  96  96  96  96  96  96  96  97  93  93  93  93  93  93   1   1   1   1   1   1   1   1   1   1   1   1   1   1  76   1   4   4   4   4   4   4   4   4   4   4   1   1   1   1   1   1   0   1   1   1   1   1  93  93  93  93
96   96  96  96  96  96  96  97  78  78  78  78   3   2   3   2   3   2   3   2   3   2 158  96  96  96  96  96  96  96  96  96  96  96  96  96  96  96  96  96  96  96  96  96  96  96  97  94  94  94  94  94  94   1   1   1   1   1   1   1   1   1   1   1   1   1   1  76   1   4   4   4   4   4   4   4   4   4   4   1   1   1   1   1   1   0   1   1   1   1   1  94  94  94  94
96   96  96  96  96  96  96  97   2   3   2   3   2   3  56  56 165 106 106 106 106 106  96  96  96  96  96  96  96  96  96  96  96  96  96  96  96  96  96  96  96  96  96  96  96  96  96 106 106 106 106 106 106 106 106 106 106 106 106 106 106 106 106 106 106 106 106 106 106 106 106 106 106 106 106 106 106 106 106 106 106 106 106 106 106 106 106 106 106 106 107   1   1   1   1
96   96  96  96  96  96  96  97   3   2   3   2   3   2  78  78 158  96  96  96  96  96  96  96  96  96  96  96  96  96  96  96  96  96  96  96  96  96  96  96  96  96  96  96  96  96  96  96  96  96  96  96  96  96  96  96  96  96  96  96  96  96  96  96  96  96  96  96  96  96  96  96  96  96  96  96  96  96  96  96  96  96  96  96  96  96  96  96  96  96  97  93  93  93  93
96   96  96  96  96  96  96  97  76   1   2   3   2   3   2   3 158  96  96  96  96  96  96  96  96  96  96  96  96  96  96  96  96  96  96  96  96  96  96  96  96  96  96  96  96  96  96  96  96  96  96  96  96  96  96  96  96  96  96  96  96  96  96  96  96  96  96  96  96  96  96  96  96  96  96  96  96  96  96  96  96  96  96  96  96  96  96  96  96  96  97  94  94  94  94
96   96  96  96  96  96  96  97  76   1   3   2   3   2   3   2 158  96  96  96  96  96  96  96  96  96  96  96  96  96  96  96  96  96  96  96  96  96  96  96  96  96  96  96  96  96  96  96  96  96  96  96  96  96  96  96  96  96  96  96  96  96  96  96  96  96  96  96  96  96  96  96  96  96  96  96  96  96  96  96  96  96  96  96  96  96  96  96  96  96  97   1   1   1   1