NAME
Route 5
MUSIC
music/18-road-to-cerulean-intro.mp3,music/18-road-to-cerulean-loop.mp3
LEAVESOUND
sound_effects/general/sfx_go_inside.mp3
NPCS
route5-sign blank 29 34
INTERACTIONS
MENU:ALERT:UNDERGROUND PATH CERULEAN CITY - VERMILION CITY
END
TELEPORT
13 0 cerulean-city 13 33
14 0 cerulean-city 14 33
15 0 cerulean-city 15 33
16 0 cerulean-city 16 33
18 0 cerulean-city 18 33
19 0 cerulean-city 19 33
20 0 cerulean-city 20 33
21 0 cerulean-city 21 33
22 0 cerulean-city 22 33
23 0 cerulean-city 23 33
24 0 cerulean-city 24 33
25 0 cerulean-city 25 33
27 0 cerulean-city 27 33
28 0 cerulean-city 28 33
29 0 cerulean-city 29 33
30 0 cerulean-city 30 33
22 26 daycare 2 7
21 35 route5-checkpoint 3 1
22 35 route5-checkpoint 4 1
29 32 route5-tunnel 3 7
NEIGHBORS
cerulean-city 0 -33
ENCOUNTERS
16 19 39 43 52 56 63 66 69
LEVELS
11-16
DATA
94  94  94  94  94  94   0   1   3   2   3   2   3   2   3   2   3   2   3   2   3   2   3   2   3   2   3   2   3   2   3   2   3   2   3   2   3   2   3   2   0   1  76  76  76  76   1   0
93  93  93  93  93  93   0   1   1   1   1   1  76   1 240 241   1  76   1   1   1   1   1   1   1   1   0   1 240 241   1   0   1   1   1   1   1   1   1   1   0   1  76  76  76  76   1   0
94  94  94  94  94  94   0   0   0   0   0   0  76   1 242 243   1  76  77  77  77  77  77  77  77  77   0   1 242 243   1   0   0   0   0   0   0   0   0   0   0   1  76  76  76  76   1   0
93  93  93  93  93  93  93  93  93  93  93  93  76   1 242 243   1  76   1   1   1   1   1   1   1   1   0   1 242 243   1   0  93  93  93  93  93  93  93  93  93  93  76  76  76  76   1   0
94  94  94  94  94  94  94  94  94  94  94  94  76   1 242 243   1  76   1   1   1   1   1   1   1   1   0   1 242 243   1   0  94  94  94  94  94  94  94  94  94  94  76  76  76  76   1   0
76  76  76  76  76  76  76  76  76  76  76  76  76   1 242 243   1  76   1   1   1   1   1   1   1   1   0   1 242 243   1   0  76  76  76  76  76  76  76  76  76  76  76  76  76  76
76  76  76  76  76  76  76  76  76  76  76  76  76   1 242 243   1  76   1   1   1   1   1   1   1   1   0   1 242 243   1   0  76  76  76  76  76
76  76  76  76  76  76  76  76  76  76  76  76  76   1 242 243   1  76   1   1   1   1   1   1   1   1   0   1 242 243   1   0  76  76  76  76  76
76  76  76  76  76  76  76  76  76  76  76  76  76   1 242 243   1  76  77  77  77  77  77  77  77  77   0   1 242 243   1   0  76  76  76  76  76
76  76  76  76  76  76  76  76  76  76  76  76  76   1 242 243   1  76   4   4   4   4   4   4   4   4   0   1 242 243   1   0   1   1   1   1   1
76  76  76  76  76  76  76  76  76  76  76  76  76   1 242 243   1  76   4   4   4   4   4   4   4   4   0   1 242 243   1   0   1   1   1   1   1
76  76  76  76  76  76  76  76  76  76  76  76  76   1 242 243   1  76   1   1   1   1   1   1   1   1   0   1 242 243   1   0   1   1   1   1   1
76  76  76  76  76  76  76  76  76  76  76  76  76   1 242 243   1  76  77  77  77  77  77  77  77  77   0   1 242 243   1   0   1   1   1   1   1
76  76  76  76  76  76  76  76  76  76  76  76  76   1 242 243   1  76   4   4   4   4   4   4   4   4   0   1 242 243   1   0   1   1   1   1   1
76  76  76  76  76  76  76  76  76  76  76  76  76   1 242 243   1  76   4   4   4   4   4   4   4   4   0   1 242 243   1   0   1   1   1   1   1
76  76  76  76  76  76  76  76  76  76  76  76  76   1 242 243   1  76   1   1   1   1   1   1   1   1   0   1 242 243   1   0   1   1   1   1   1
76  76  76  76  76  76  76  76  76  76  76  76  76   1 242 243   1  76  77  77  77  77  77  77  77  77   0   1 242 243   1   0   1   1   1   1   1
76  76  76  76  76  76  76  76  76  76  76  76  76   1 242 243   1  76   4   4   4   4   4   4   4   4   0   1 242 243   1   0   1   1   1   1   1
76  76  76  76  76  76  76  76  76  76  76  76  76   1 242 243   1  76   4   4   4   4   4   4   4   4   0   1 242 243   1   0   1   1   1   1   1
76  76  76  76  76  76  76  76  76  76  76  76  76   1 242 243   1  76   1   1   1   1   1   1   1   1   0   1 242 243   1   0   1   1   1   1   1
76  76  76  76  76  76  76  76  76  76  76  76  76   1 242 243   1  76  77  77  77  77  77  77  77  77   0   1 242 243   1   0   1   1   1   1   1
76  76  76  76  76  76  76  76  76  76  76  76  76   1 242 243   2  55  56  56  56  56  56  56  56  56  55   3 242 243   1   0   1   1   1   1   1
76  76  76  76  76  76  76  76  76  76  76  76  76   1 242 243   3  55  56  56  56  56  56  56  56  56  55   2 242 243   1   0   1   1   1   1   1
76  76  76  76  76  76  76  76  76  76  76  76  76   1 242 243   2  55  56  56  70  71  71  72  56  56  55   3 242 243   1   0   1   1   1   1   1
76  76  76  76  76  76  76  76  76  76  76  76  76   1 242 243   3  55  56  56  67  68  68  69  56  56  55   2 242 243   1   0   1   1   1   1   1
76  76  76  76  76  76  76  76  76  76  76  76  76   1 242 243   2  55  56  56  61  62  62  66  56  56  55   3 242 243   1   0   1   1   1   1   1
76  76  76  76  76  76  76  76  76  76  76  76  76   1 295 296   3  55  56  56  57  58  15  60  56  56  55   2 295 296   1   0   1   1   1   1   1
76  76  76  76  76  76  76  76  76  76  76  76  76   1   2   3   2  55  56  56  56  56  56  56  56  56  55   3   2   3   1   0   1   1   1   1   1
76  76  76  76  76  76  76  76  76  76  76  76  76   1   3   2   3  55  78  78  78  78  78  78  78  78  55   2   3   2   1   0   1   1   1   1   1
76  76  76  76  76  76  76  76  76  76  76  76  76   1   2   3   2   3   2   3   2   3   2   3   2   3   2   3 102  71  71 103   1   1   1   1   1
76  76  76  76  76  76  76  76  76  76  76  76  76   1   3   2   3   2   3   2   3   2   3   2   3   2   3   2 104  68  68 105   1   1   1   1   1
76  76  76  76  76  76  76  76  76  76  76  76  76   1   2   3   2   3   2   3   2   3   2   3   2   3   2   3 108  65  65 109   1   1   1   1   1
76  76  76  76  76  76  76  76  76  76  76  76  76   1   3   2   3   2   3   2   3   2   3   2   3   2   3   2 110  15 164 112   1   1   1   1   1
76  76  76  76  76  76  76  76  76  76  76  76  76   1   2   3   2   3   2   3  55   3   3  55   2   3   2   3  56  56   1   0   1   1   1   1   1
76  76  76  76  76  76  76  76  76  76  76  76  76   1   3   2   3   2   3   2  55   3   3  55   3   2   3   2  56   5   1   0   1   1   1   1   1
76  76  76  76  76  76  76  76  76  76  76  76  76   1   2   3   2   3 102  71  71 168 168  71  71 103   2   3   2   3   1   0   1   1   1   1   1
76  76  76  76  76  76  76  76  76  76  76  76  76   1   3   2   3   2 104  68  68  68  68  68  68 105   3   2   3   2   1   0   1   1   1   1   1
1    1   1   1   1   1   1   1   1   1   1   1   1  76  56  56  56  56 108  65  65  65  63  64  65 109  56  56  56  56  76   1   1   1   1   1   1
1    1   1   1   1   1   1   1   1   1   1   1   1  76  55  55  55  55 110 164 164 164  15  58 164 112  55  55  55  55  76   1   1   1   1   1   1
1    1   1   1   1   1   1   1   1   1   1   1   1  76  93  93  93  93   1   1   1   1   1   1   1   1  93  93  93  93  76   1   1   1   1   1   1
1    1   1   1   1   1   1   1   1   1   1   1   1  76  94  94  94  94   1   1   1   1   1   1   1   1  94  94  94  94  76   1   1   1   1   1   1
1    1   1   1   1   1   1   1   1   1   1   1   1  76  93  93  93  93   1   1   1   1   1   1   1   1  93  93  93  93  76   1   1   1   1   1   1
1    1   1   1   1   1   1   1   1   1   1   1   1  76  94  94  94  94   1   1   1   1   1   1   1   1  94  94  94  94  76   1   1   1   1   1   1