NAME
Route 5 Tunnel
NPCS
route5-tunnel-woman woman3 2 3
INTERACTIONS
MENU:ALERT:People often lose things in that UNDERGROUND PATH.
END
TELEPORT
3 8 route6 22 15
4 8 route6 22 15
4 4 tunnel1 2 39
DATA
30  265 265 265 265 265 265  30
29  182 182 182 182 182 182  29
182 301 305 182 182 303 302 182
182 134 182 182 182 182 134 182
182 134 182 182  39 182 134 182
182 134 182 182 182 182 134 182
30  303 305 182 182 303 305  30
29  182 182  54  54 182 182  29
82   82  82 166 166
