NAME
Safari Zone Main
NPCS
safari-zone-checkpoint-guard2 guard 1 5 RIGHT FARSPEAK
INTERACTIONS
MENU:ALERT_YES_NO:Hi! Is it your first time here?|{MENU:ALERT:SAFARI ZONE has 4 zones in it.|MENU:ALERT:Each zone has different kinds of POK{e-accent}MON.|MENU:ALERT:Entry fees help pay for the care and maintenance of the SAFARI ZONE.}{MENU:ALERT:Sorry, you're a regular here!}
END
TELEPORT
3 7 fuchsia-city 23 7
4 7 fuchsia-city 23 7
ENCOUNTERS
30 33 47 49 102 111 113 114 123 127
MEGA_ENCOUNTERS
133
WATER_ENCOUNTERS_OLD
129
WATER_ENCOUNTERS_GOOD
60 118
WATER_ENCOUNTERS_SUPER
55 79 99 147
LEVELS
36-42
MEGA_LEVELS
5-5
DATA
82   82  82  82  82  82  82  82  82  82  82  82  82  82  82 166 166
82  684 685 685 685 685 685 685 685 685 685 171 172 685 685 187 188 685 685 685 685 685 685 685 685 685 685 685 685 685 684
82  684 685 684 684 684 684 684 684 684 684 173 174 684 684 684 684 684 684 684 684 684 684 684 684 684 684 684 684 685 684
82  685 684 684 684 684 186 186 684 687 684 684 685 684 684 684 684 684 186 186 684 684 186 186 684 684 684 684 684 684 685
82  685 684 684 684 186 186 186 186 684 684 684 685 684 684 684 684 186 186 186 186 186 186 186 186 684 688 684 684 684 685
82  685 684 684 186 177 178 177 178 186 684 684 685 684 684 684 186 177 178 177 178 177 178 177 178 186 684 684 684 684 685
82  685 684 186 186 179 178 179 178 186 186 684 685 684 688 186 186 179 178 179 178 179 178 179 178 186 186 684 684 684 685
82  685 684 186 186 177 178 186 186 684 684 684 685 684 684 186 186 177 178 186 186 186 186 177 178 186 186 687 684 684 685
82  685 684 684 186 179 178 186 684 684 684 684 685 684 684 684 186 179 178 186 684 684 186 179 178 186 684 684 684 684 685
82  685 684 684 684 186 186 684 186  92  88  88  88  88  88  88  88  88  88  88  88  88  91 684 684 684 684 684 684 171 172
82  685 684 684 684 186 684 186 186  90  81  81  81  81  81  81  81  81  81  81  81  81  89 685 685 685 685 685 685 173 174
166 690 684 684 684 684 684 177 178  90  81  81 692 684 684 689 684 684 684 693  81  81  89 684 684 689 684 684 684 684 694 166
166 691 684 684 684 684 684 179 178  90  81  81  89 684 684 684 686 684 684  90  81  81  89 684 684 684 686 684 684 684 695 166
82  685 684 689 684 684 684 186 186  90  81  81  87  88  88  88  88  88  88  86  81  81  89
82  685 684 684 686 684 684 684 186  90  81  81  81  81  81  81  81  81  81  81  81  81  89
82  685 684 684 684 687 684 684 684 684 684 696 684 684 696 684 684 696 684 684 696 684 684
82  685 684 684 684 684 684 685 685 685 685 697 698 698 697 698 698 697 698 698 697 684 684 684
82  171 172 685 685 685 685 684 684 684 684 684 684 684 684 684 684 684 684 684 684 684 684
82  173 174 684 684 684 684 684 684 684 684 684 684 684 684 684 684 684 684 684 684 684 684
82  685 684 684 684 684 186 177 178 177 178 186 684 687 684 684 684
82  685 684 684 684 186 186 179 178 179 178 186 186 684 684 684 684
82  685 684 687 684 186 186 177 178 177 178 186 186 684 684 684 684 684 684 699 684 684 684 684
82  685 684 684 684 684 186 179 178 179 178 186 684 684 684 684 684 684 684 684 684 684 684
82  685 684 684 684 684 684 186 186 177 178 177 178 186 186 699 684 687 684 687 684 684
82  685 684 684 684 684 688 684 186 179 178 179 178 186 684 684 684 684 684 684 684
82  684 685 696 684 684 684 684 696 684 684 684 684 684 696 684 684 696 684 684 684 684 684 696 684 684 684 684 696 685 684
82  684 685 697 698 698 698 698 697 698 698 698 698 698 697 700 701 697 698 698 698 698 698 697 698 698 698 698 697 685 684
82  82  82  82  82  82  82  82  82  82  82  82  82  82  82  166 166