NAME
Saffron City
NPCS
saffron-city-rocket-house1 rocket 16 13
INTERACTIONS
MENU:ALERT:What do you want? Get lost!
END
saffron-city-rocket-house2 rocket 14 19
INTERACTIONS
MENU:ALERT:Buzz off, kid!
END
saffron-city-rocket-house3 rocket 22 19
INTERACTIONS
MENU:ALERT:SAFFRON belongs to TEAM ROCKET!
END
saffron-city-rocket-silph rocket 27 29
INTERACTIONS
MENU:ALERT:I'm a security guard.|MENU:ALERT:Suspicious kids I don't allow in!
END
saffron-city-rocket-gym rocket 43 11
INTERACTIONS
MENU:ALERT:Get out of the way!
END
saffron-city-rocket-wander1 rocket 29 15 WANDER
INTERACTIONS
MENU:ALERT:BOSS said he'll take this town!
END
saffron-city-rocket-wander2 rocket 40 20 WANDER
INTERACTIONS
MENU:ALERT:Ow! Watch where you're walking!
END
saffron-city-rocket-wander3 rocket 21 32 WANDER
INTERACTIONS
MENU:ALERT:Being evil makes me feel so alive!
END
saffron-city-rocket-wander4 rocket 25 38 WANDER
INTERACTIONS
MENU:ALERT:With SILPH under control, we can exploit POK{e-accent}MON around the world!
END
saffron-city-sign1 blank 26 12
INTERACTIONS
MENU:ALERT:SAFFRON CITY Shining, Golden Land of Commerce
END
saffron-city-sign2 blank 36 12
INTERACTIONS
MENU:ALERT:FIGHTING DOJO
END
saffron-city-sign3 blank 44 12
INTERACTIONS
MENU:ALERT:SAFFRON CITY POK{e-accent}MON GYM LEADER: SABRINA|MENU:ALERT:The Master of Psychic POK{e-accent}MON!
END
saffron-city-sign4 blank 10 26
INTERACTIONS
MENU:ALERT:SILPH's latest product!|MENU:ALERT:Release to be determined...
END
saffron-city-sign5 blank 14 28
INTERACTIONS
MENU:ALERT:TRAINER TIPS|MENU:ALERT:New GREAT BALL offers improved capture rates.|MENU:ALERT:Try it on hard-to-catch POK{e-accent}MON.
END
saffron-city-sign6 blank 24 28
INTERACTIONS
MENU:ALERT:SILPH CO. {NEWLINE} OFFICE BUILDING
END
saffron-city-sign7 blank 48 26
INTERACTIONS
MENU:ALERT:TRAINER TIPS|MENU:ALERT:FULL HEAL cures all ailments like SLEEP and BURN.|MENU:ALERT:It costs a bit more, but it's more convenient.
END
saffron-city-sign8 blank 36 36
INTERACTIONS
MENU:ALERT:MR. PSYCHIC's HOUSE
END
TELEPORT
6 25 route7-checkpoint 6 4
29 4 route5-checkpoint 3 6
29 45 route6-checkpoint 3 1
51 25 route8-checkpoint 1 4
35 10 saffron-dojo 4 11
18 36 saffron-center 3 7
34 18 saffron-mart 3 7
38 36 saffron-house1 2 7
DATA
76  76  76  76  76  76  76  76  76  76  76  76  76  76  76  76  76  76   1  76   1   3   2   3   2   3   2  55   3   3  55   3   2   3   2  56   5   1   0   1   1   1   1   1   1   3   2   3   2   3   2   3   2   3   2   3   2
76  76  76  76  76  76  76  76  76  76  76  76  76  76  76  76  76  76   1  76   1   2   3   2   3 102  71  71  71  71  71  71 103   2   3   2   3   1   0   1   1   1   1   1   1   2   3   2   3   2   3   2   3   2   3   2   3
76  76  76  76  76  76  76  76  76  76  76  76  76  76  76  76  76  76   1  76   1   3   2   3   2 104  68  68  68  68  68  68 105   3   2   3   2   1   0   1   1   1   1   1   1   3   2   3   2   3   2   3   2   3   2   3   2
76  76  76  76  76  76  76  76  76  76  76  76  76  76  76  76  76  76  76   1  76  56  56  56  56 108  65  65  65  63  64  65 109  56  56  56  56  76   1   1   1   1   1   1   1   2   3   2   3   2   3   2   3   2   3   2   3
76  76  76  76  76  76  76  76  76  76  76  76  76  76  76  76  76  76  76   1  76  55  55  55  55 110 164 164 164  15  58 164 112  55  55  55  55  76   1   1   1   1   1   1   1   3   2   3   2   3   2   3   2   3   2   3   2
76  76  76  76  76  76  76  76  76  76  76  76  76  76  76  76  76  76  76   1  76  93  93  93  93   1   1   1   1   1   1   1   1  93  93  93  93  76   1   1   1   1   1   1   1   2   3   2   3   2   3   2   3   2   3   2   3
76  76  76  76  76  76  76  76  76  76  76  76  76  76  76  76  76  76  76   1  76  94  94  94  94   1   1   1   1   1   1   1   1  94  94  94  94  76   1   1   1   1   1   1   1   3   2   3   2   3   2   3   2   3   2   3   2
76  76  76  76  76  76  76  76  76   1   1   1   1   1   1   1   1   1   1   1   0   1   1   1   1   1   1  56  56  56  56  70  71  71  71  71  72  70  71  71  71  71  71  71  72   2   3   2   3   2   3   2   3   2   3   2   3
76  76  76  76  76  76  76  76  76   0   0   0   0   0   0   0   0   0   0   0   0   0   0   0   0   0   0  56  56  56  56  67  68  68  68  68  69  67  68  68  68  68  68  68  69 575 576 576 577  76  76  76  76 165 106 106 106
76  76  76  76  76  76  76  76  76   0   1   2   3   2   3   2   3   2   3   2   3   2   3  56  56  56  56  56  56  56  56  61  62 100 101  62  66  61  62 100 101 100 101  62  66 578 579 580 581  76  76  76  76 158  96  96  96
76  76  76  76  76  76  76  76  76   0   1 575 576 576 577 575 576 576 577 575 576 576 577  56  56  56  56  56  56  56  56  57  58  58  58  15  60  57  58  58  58  58  58  15  60 586 587 587 588  76  76  76  76 158  96  96  96
76  76  76  76  76  76  76  76  76   0   1 578 579 580 581 582 583 584 585 578 579 580 581  56  56  56  56  56  56  56  56  56  56  56  56  56  56  56  56  56  56  56  56  56  56  56  56   1   0  76  76  76  76 158  96  96  96
76  76  76  76  76  76  76  76  76   0   1 586 587 587 588 589  15 587 590 586 587 587 588  55  55  55   5  55  55  56  56  56  56  55  55  55   5  55  55  56  56  55  55  55   5  55  55   1   0  76  76  76  76 158  96  96  96
76  76  76  76  76  76  76  76  76   0   1 322 323 323 323 323 323 323 323 323 323 323 323 323 323 323 323 323 323 323 323 323 323 323 323 323 323 323 323 323 323 323 323 323 323 323 324   1   0  76  76  76  76 158  96  96  96
76  76  76  76  76  76  76  76  76   0   1 242 328 326 326 326 326 326 326 326 326 326 326 326 326 326 326 326 326 326 326 326 326 326 326 326 326 326 326 326 326 326 326 326 326 330 243   1   0  76  76  76  76 158  96  96  96
76  76  76  76  76  76  76  76  76   0   1 242 243   2   3   2   3   2   3   2   3   2   3   2   3  56  56  56  56  56  56  56  56 102  71  71 103   2   3   2   3   2   3   2   3 242 243   1   0   0   0   0   0 158  96  96  96
76  76  76  76  76  76  76  76  76   0   1 242 243 575 576 576 577 575 576 576 577 575 576 576 577  56  56  56  56  56  56  56  56 104  68  68 105 575 576 576 577 575 576 576 577 242 243   1   0   0   0   0   0 158  96  96  96
4    4   4   4   4   2  55 482 482   1   1 242 243 578 579 580 581 578 579 580 581 582 583 584 585 102  71  71  71  71  71  71 103 108  65  65 109 578 579 580 581 578 579 580 581 242 243   1   0   0   0   0   0 158  96  96  96
4    4   4   4   4   3  55 482 482   1   1 242 243 586  15 587 588 586 587 587 588 589  15 587 590 104  68  68  68  68  68  68 105 110  15 111 112 586 587 587 588 586 587 587 588 242 243   1   0   0   0   0   0 162  99  99  99
93  93  93  93  93   2  55 482 482   1   1 242 329 323 323 323 323 323 323 323 323 323 323 323 323 108  65  65  65  65  65  65 109 323 323 323 323 323 323 323 323 323 323 323 323 331 243   1   0   0   0   0   0   0   1   3   2
94  94  94  94  94   3  55 482 482   1   1 242 328 326 326 326 326 326 326 326 326 326 326 326 326 108  65  65  65  65  65  65 109 326 326 326 326 326 326 326 326 326 326 326 326 330 243   1   0   0   0   0   0   0   1   2   3
56  56  56  56  56   2  55 482 482   1   1 242 243 163 163 163 163 163 163 163 163 163 163 163 163 108  65  65  65  65  65  65 109 163 163 163 163 163 163 163 163 163 163 163 163 242 243   1   0   0   0   0   0   0   1   3   2
56  56  56  56  56   3  55 482 482   1   1 242 243 163 163 163 163 163 163 163 163 163 163 163 163 108  65  65  65  65  65  65 109 163 163 163 163 163 163 163 163 163 163 163 163 242 243   1   0   0   0   0   0   0   1   2   3
55 102  71  71  71  71 103   2   3   2   3 242 243  56  56 102  71  71 103 102  71  71 103  56  56 108  65  65  65  65  65  65 109 102  71  71 103 102  71  71 103 102  71  71 103 242 243   2   3   2   3 102  71  71  71  71 103
55 104  68  68  68  68 105   3   2   3   2 242 243  56  56 104  68  68 105 104  68  68 105  56  56 108  65  65  65  65  65  65 109 104  68  68 105 104  68  68 105 104  68  68 105 242 243   3   2   3   2 104  68  68  68  68 105
56 453  65  65  65  65 455  56  56  56  56 331 243  56  56 108  65  65 109 108  65  65 109  56  56 108  65  65  65  65  65  65 109 108  65  65 109 108  65  65 109 108  65  65 109 242 329  56  56  56  56 453  65  65  65  65 455
78 110 164 164 164 164 112  55  55  55   5 330 243  56  56 108  65  65 109 108  65  65 109  56  56 108  65  65  65  65  65  65 109 108  65  65 109 108  65  65 109 108  65  65 109 242 328  55   5  55  55 110 164 164 164 164 112
56  56  56  56  56   3  55 482 482   1   1 242 243  56  56 108  65  65 109 108  65  65 109  56  56 108  65  63  64  65  65  65 109 108  65  65 109 108  65  65 109 108  65  65 109 242 243   1   0   0   0   0   0   0   1   1   1
56  56  56  56  56   3  55 482 482   1   1 242 243  55   5 110 164 164 112 110 164 164 112  55   5 110 164  15 587 164 164 164 112 110 164 164 112 110 164 164 112 110 164 164 112 242 243   1   0   0   0   0   0   0   1   1   1
56  56  56  56  56   3  55 482 482   1   1 242 329 323 323 323 323 323 323 323 323 323 323 323 323 323 323 323 323 323 323 323 323 323 323 323 323 323 323 323 323 323 323 323 323 331 243   1   0   0   0   0   0   0   1   1   1
56  56  56  56  56   3  55 482 482   1   1 242 328 326 326 326 326 326 326 326 326 326 326 326 326 326 326 326 326 326 326 326 326 326 326 326 326 326 326 326 326 326 326 326 326 330 243   1   0   0   0   0   0   0   1   1   1
76  76  76  76  76  76  76  76  76   0   1 242 243 163 163 163 163 163 163 163 163 163 163 163 163 163 163 163 163 163 163 163 163 163 163 163 163 163 163 163 163 163 163 163 163 242 243   1   0   0   0 165 106 106 106 106 106
76  76  76  76  76  76  76  76  76   0   1 242 243 163 163 163 163 163 163 163 163 163 163 163 163 163 163 163 163 163 163 163 163 163 163 163 163 163 163 163 163 163 163 163 163 242 243   1   0   0   0 158  96  96  96  96  96
76  76  76  76  76  76  76  76  76   0   1 242 243   2   3   2   3 102  71  71 103   2   3   2   3   2   3   2   3   2   3   2   3  56  56  56  56 102  71  71 103   2   3   2   3 242 243   1   0  76  76 158  96  96  96  96  96
76  76  76  76  76  76  76  76  76   0   1 242 243 575 576 576 577 104  68  68 105 575 576 576 577 575 576 576 577 575 576 576 577  56  56  56  56 104  68  68 105 575 576 576 577 242 243   1   0  76  76 158  96  96  96  96  96
76  76  76  76  76  76  76  76  76   0   1 242 243 578 579 580 581 108  65  65 109 578 579 580 581 578 579 580 581 578 579 580 581  56  56  56  56 108  65  65 109 578 579 580 581 242 243   1   0  76  76 158  96  96  96  96  96
76  76  76  76  76  76  76  76  76   0   1 242 243 586 587 587 588 110  15 113 112 586 587 587 588 586 587 587 588 586 587 587 588  55  55  55   5 110  15 164 112 586 587 587 588 242 243   1   0  76  76 158  96  96  96  96  96
76  76  76  76  76  76  76  76  76   0   1 242 329 323 323 323 323 323 323 323 323 323 323 323 323 323 323 323 323 323 323 323 323 323 323 323 323 323 323 323 323 323 323 323 323 331 243   1   0  76  76 158  96  96  96  96  96
76  76  76  76  76  76  76  76  76   0   1 325 326 326 326 326 326 326 326 326 326 326 326 326 326 326 326 326 326 326 326 326 326 326 326 326 326 326 326 326 326 326 326 326 326 326 327   1   0  76  76 162  99  99  99  99  99
76  76  76  76  76  76  76  76  76 102  71  71 103   2   3   2   3   2   3   2   3   2   3   2   3   2   3   2   3  56  56  56  56   2   3   2   3   2   3   2   3   2   3   2   3 102  71  71 103  76  76  76  76  76  76  76  76
76  76  76  76  76  76  76  76  76 104  68  68 105 575 576 576 577 575 576 576 577 575 576 576 577 575 576 576 577  56  56  56  56 575 576 576 577 575 576 576 577 575 576 576 577 104  68  68 105  76  76  76  76  76  76  76  76
76  76  76  76  76  76  76  76  76 108  65  65 109 578 579 580 581 578 579 580 581 578 579 580 581 578 579 580 581   1   1  56  56 578 579 580 581 578 579 580 581 578 579 580 581 108  65  65 109  76  76  76  76  76  76  76  76
76  76  76  76  76  76  76  76  76 110 164 164 112 586 587 587 588 586 587 587 588 586 587 587 588 586 587 587 588   1   1  55  55 586 587 587 588 586 587 587 588 586 587 587 588 110 164 164 112  76  76  76  76  76  76  76  76
76  76  76  76  76  76  76  76  76  76  76  76  76  76  76  76  76  76  76  93  93  93  93  93  93   1   1   1   0   1   0   1   1  93  93  93  93  93  93  76  76  76  76  76  76  76  76  76  76  76  76  76  76  76  76  76  76
76  76  76  76  76  76  76  76  76  76  76  76  76  76  76  76  76  76  76  94  94  94  94  94  94   1   1   1   0   1   0   1   1  94  94  94  94  94  94  76  76  76  76  76  76  76  76  76  76  76  76  76  76  76  76  76  76
76  76  76  76  76  76  76  76  76  76  76  76  76  76  76  76  76  76  76   0   0   0   0   0   0   0   0 102  71 168  71  71 103   0   0   0   0   0   0  76  76  76  76  76  76  76  76  76  76  76  76  76  76  76  76  76  76
76  76  76  76  76  76  76  76  76  76  76  76  76  76  76  76  76  76  76   1   1   1   1   1   1   1   1 104  68  68  68  68 105   1   1   1   1   1   1  76  76  76  76  76  76  76  76  76  76  76  76  76  76  76  76  76  76
76  76  76  76  76  76  76  76  76  76  76  76  76  76  76  76  76  76  76  93  93  93  93  93  93   1   1 108  65  65  65  65 109  93  93  93  93  93  93  76  76  76  76  76  76  76  76  76  76  76  76  76  76  76  76  76  76
76  76  76  76  76  76  76  76  76  76  76  76  76  76  76  76  76  76  76  94  94  94  94  94  94   1   1 108  65  65  65  65 109  94  94  94  94  94  94  76  76  76  76  76  76  76  76  76  76  76  76  76  76  76  76  76  76
76  76  76  76  76  76  76  76  76  76  76  76  76  76  76  76  76  76  76   1   1   1   1   1   1   1   1 108  65  63  64  65 109   1   1   1   1   1   1  76  76  76  76  76  76  76  76  76  76  76  76  76  76  76  76  76  76
76  76  76  76  76  76  76  76  76  76  76  76  76  76  76  76  76  76  76  77  77  77  79  77  77  77  77 110 164  15  58 164 112  77  77  77  79  77  77  76  76  76  76  76  76  76  76  76  76  76  76  76  76  76  76  76  76