NAME
Seafoam Islands
NPCS
seafoam-islands-sign1 blank 25 111
INTERACTIONS
MENU:ALERT:DANGER {NEWLINE} Fast current!
END
seafoam-islands-sign2 blank 11 125
INTERACTIONS
MENU:ALERT:Boulders might change the flow of water!
END
seafoam-islands-item1 blank 27 127
INTERACTIONS
GIVE_ITEM:ULTRA BALL|DEACTIVATE:seafoam-islands-item1
END
seafoam-islands-stone1 boulder 20 12 PUSHABLE TELEPORTABLE
INTERACTIONS
MENU:ALERT:This requires STRENGTH to move!|NO_ADVANCE
ACTIVATE:seafoam-islands-stone2|DEACTIVATE:seafoam-islands-stone1
END
seafoam-islands-stone2 boulder 19 35 PUSHABLE TELEPORTABLE INACTIVE
INTERACTIONS
MENU:ALERT:This requires STRENGTH to move!|NO_ADVANCE INACTIVE
ACTIVATE:seafoam-islands-stone3|DEACTIVATE:seafoam-islands-stone2
END
seafoam-islands-stone3 boulder 20 62 PUSHABLE TELEPORTABLE INACTIVE
INTERACTIONS
MENU:ALERT:This requires STRENGTH to move!|NO_ADVANCE
ACTIVATE:seafoam-islands-stone4|DEACTIVATE:seafoam-islands-current1|DEACTIVATE:seafoam-islands-current3|DEACTIVATE:seafoam-islands-current5|DEACTIVATE:seafoam-islands-current7|DEACTIVATE:seafoam-islands-stone3
END
seafoam-islands-stone4 boulder 20 89 INACTIVE
INTERACTIONS
MENU:ALERT:It's blocking the current!
END
seafoam-islands-current1 blank 21 89
FORCE_INTERACTION
0 1
END
INTERACTIONS
MOVE:PLAYER:0,1|MOVE:PLAYER:0,1|MOVE:PLAYER:0,1|MOVE:PLAYER:0,1|MOVE:PLAYER:1,0|MOVE:PLAYER:0,1|MOVE:PLAYER:0,1|MOVE:PLAYER:0,1|MOVE:PLAYER:0,1|MOVE:PLAYER:0,1|MOVE:PLAYER:0,1|TELEPORT:seafoam-islands 22 127
END
seafoam-islands-current2 blank 21 89
FORCE_INTERACTION
0 1
END
INTERACTIONS
MOVE:PLAYER:0,1|MOVE:PLAYER:0,1|MOVE:PLAYER:0,1|MOVE:PLAYER:0,1|MOVE:PLAYER:1,0|MOVE:PLAYER:0,1|MOVE:PLAYER:0,1|MOVE:PLAYER:0,1|MOVE:PLAYER:0,1|MOVE:PLAYER:0,1|MOVE:PLAYER:0,1|TELEPORT:seafoam-islands 22 127
END
seafoam-islands-current3 blank 22 128
FORCE_INTERACTION
0 -1
1 -1
END
INTERACTIONS
MOVE:PLAYER:0,-1
END
seafoam-islands-current4 blank 22 128
FORCE_INTERACTION
0 -1
1 -1
END
INTERACTIONS
MOVE:PLAYER:0,-1
END
seafoam-islands-current5 blank 17 91
INTERACTIONS
MENU:ALERT:The current is too strong!
END
seafoam-islands-current6 blank 17 91
INTERACTIONS
MENU:ALERT:The current is too strong!
END
seafoam-islands-current7 blank 25 93
INTERACTIONS
MENU:ALERT:The current is too strong!
END
seafoam-islands-current8 blank 25 93
INTERACTIONS
MENU:ALERT:The current is too strong!
END
seafoam-islands-stone5 boulder 28 9 PUSHABLE TELEPORTABLE
INTERACTIONS
MENU:ALERT:This requires STRENGTH to move!|NO_ADVANCE
ACTIVATE:seafoam-islands-stone6|DEACTIVATE:seafoam-islands-stone5
END
seafoam-islands-stone6 boulder 24 35 PUSHABLE TELEPORTABLE INACTIVE
INTERACTIONS
MENU:ALERT:This requires STRENGTH to move!|NO_ADVANCE
ACTIVATE:seafoam-islands-stone7|DEACTIVATE:seafoam-islands-stone6
END
seafoam-islands-stone7 boulder 25 62 PUSHABLE TELEPORTABLE INACTIVE
INTERACTIONS
MENU:ALERT:This requires STRENGTH to move!|NO_ADVANCE
ACTIVATE:seafoam-islands-stone8|DEACTIVATE:seafoam-islands-current2|DEACTIVATE:seafoam-islands-current4|DEACTIVATE:seafoam-islands-current6|DEACTIVATE:seafoam-islands-current8|DEACTIVATE:seafoam-islands-stone7
END
seafoam-islands-stone8 boulder 21 89 INACTIVE
INTERACTIONS
MENU:ALERT:It's blocking the current!
END
seafoam-islands-stone9 boulder 11 97 PUSHABLE
INTERACTIONS
MENU:ALERT:This requires STRENGTH to move!|NO_ADVANCE
END
seafoam-islands-stone10 boulder 7 97 PUSHABLE
INTERACTIONS
MENU:ALERT:This requires STRENGTH to move!|NO_ADVANCE
END
seafoam-islands-stone11 boulder 10 97 PUSHABLE TELEPORTABLE
INTERACTIONS
MENU:ALERT:This requires STRENGTH to move!|NO_ADVANCE
ACTIVATE:seafoam-islands-stone12|DEACTIVATE:seafoam-islands-current9|DEACTIVATE:seafoam-islands-current11|DEACTIVATE:seafoam-islands-stone11
END
seafoam-islands-stone12 boulder 7 125 INACTIVE
INTERACTIONS
MENU:ALERT:It's blocking the current!
END
seafoam-islands-stone13 boulder 5 98 PUSHABLE TELEPORTABLE
INTERACTIONS
MENU:ALERT:This requires STRENGTH to move!|NO_ADVANCE
ACTIVATE:seafoam-islands-stone14|DEACTIVATE:seafoam-islands-current10|DEACTIVATE:seafoam-islands-current12|DEACTIVATE:seafoam-islands-stone13
END
seafoam-islands-stone14 boulder 6 125 INACTIVE
INTERACTIONS
MENU:ALERT:It's blocking the current!
END
seafoam-islands-current9 blank 7 125
FORCE_INTERACTION
0 -1
END
INTERACTIONS
MOVE:PLAYER:0,-1|MOVE:PLAYER:1,0|MOVE:PLAYER:1,0|MOVE:PLAYER:0,-1|MOVE:PLAYER:0,-1
END
seafoam-islands-current10 blank 7 125
FORCE_INTERACTION
0 -1
END
INTERACTIONS
MOVE:PLAYER:0,-1|MOVE:PLAYER:1,0|MOVE:PLAYER:1,0|MOVE:PLAYER:0,-1|MOVE:PLAYER:0,-1
END
seafoam-islands-current11 blank 9 122
INTERACTIONS
MENU:ALERT:The current is too strong!
END
seafoam-islands-current12 blank 9 122
INTERACTIONS
MENU:ALERT:The current is too strong!
END
seafoam-islands-articuno bird 8 111
INTERACTIONS
MENU:ALERT:Gyaoo!|WILD_BATTLE:144-144:50|{NO_ADVANCE}{DEACTIVATE:seafoam-islands-articuno}
END
TELEPORT
6 19 route20 46 10
7 19 route20 46 10
9 7 seafoam-islands 9 35
9 34 seafoam-islands 9 8
6 31 seafoam-islands 7 60
7 59 seafoam-islands 6 32
15 36 seafoam-islands 15 64
15 63 seafoam-islands 15 37
7 69 seafoam-islands 7 94
7 95 seafoam-islands 7 68
10 89 seafoam-islands 13 118
13 117 seafoam-islands 10 90
27 114 seafoam-islands 26 87
27 87 seafoam-islands 26 114
27 86 seafoam-islands 26 59
27 59 seafoam-islands 26 86
21 71 seafoam-islands 21 43
21 44 seafoam-islands 21 70
27 97 seafoam-islands 27 69
27 70 seafoam-islands 27 96
27 67 seafoam-islands 27 39
27 40 seafoam-islands 27 68
25 44 seafoam-islands 25 16
25 17 seafoam-islands 25 43
27 5 seafoam-islands 27 33
27 32 seafoam-islands 27 6
28 19 route20 56 14
29 19 route20 56 14
19 8 seafoam-islands 20 36
20 35 seafoam-islands 21 63
21 62 seafoam-islands 21 90
26 8 seafoam-islands 25 36
25 35 seafoam-islands 24 63
24 62 seafoam-islands 21 90
8 99 seafoam-islands 7 124
5 99 seafoam-islands 7 124
ENCOUNTERS
42 55 80 87 90 99 117 120
MEGA_ENCOUNTERS
131 134
WATER_ENCOUNTERS_OLD
129
WATER_ENCOUNTERS_GOOD
60 118
WATER_ENCOUNTERS_SUPER
73 90 119 120
LEVELS
42-48
MEGA_LEVELS
54-55
DATA
231 231 231 231 231 231 231 231 231 231 231 231 231 231 231 231 231 231 231 231 231 231 231 231 231 231 231 231 231 231 231 231 231 231
231 231 231 231 231 231 231 231 231 231 231 231 231 231 231 231 231 231 231 231 231 231 231 231 231 231 231 231 231 231 231 231 231 231
231 231 216 216 216 216 216 216 216 216 216 216 216 216 216 216 216 216 216 216 216 216 216 216 216 216 216 216 216 216 216 216 231 231
231 231 216 216 216 216 216 216 216 216 216 216 216 216 216 216 216 216 216 216 216 216 216 216 216 216 216 216 216 216 216 216 231 231
231 231 216 216 219 233 233 233 233 233 233 233 233 233 233 233 233 233 233 233 233 233 233 233 233 221 201 201 201 201 216 216 231 231
231 231 216 216 215 224 224 224 224 224 224 224 224 224 224 224 224 224 224 224 224 224 224 224 224 218 201 227 201 201 216 216 231 231
231 231 216 216 215 224 224 224 224 224 224 224 224 224 224 224 224 224 224 224 224 224 224 224 224 218 201 201 201 201 216 216 231 231
231 231 216 216 215 224 224 224 224 227 224 224 222 216 216 216 216 216 216 216 216 216 216 230 216 217 201 201 201 201 216 216 231 231
231 231 216 216 215 224 224 224 224 224 224 224 218 201 201 201 201 201 201 728 201 201 483 201 201 201 728 201 201 201 216 216 231 231
231 231 216 216 215 224 224 224 224 224 224 224 218 201 201 201 201 201 201 201 201 201 483 201 201 201 201 201 201 201 216 216 231 231
231 231 216 216 215 224 224 224 224 224 224 224 218 201 201 201 201 201 201 201 201 201 483 201 201 201 201 201 201 201 216 216 231 231
231 231 216 216 215 224 224 224 224 224 224 224 218 201 201 201 201 201 201 201 201 201 483 201 201 201 201 201 201 201 216 216 231 231
231 231 216 216 215 224 224 224 224 224 224 224 218 201 201 201 201 201 201 201 201 201 483 201 201 201 201 201 201 201 216 216 231 231
231 231 216 216 214 216 216 216 230 230 216 216 217 201 201 201 201 201 201 201 201 201 483 483 483 483 483 483 483 483 216 216 231 231
231 231 216 216 201 201 201 201 201 201 201 201 201 201 201 201 201 201 201 201 201 201 483 201 201 201 201 201 201 201 216 216 231 231
231 231 216 216 201 201 201 201 201 201 201 201 201 201 201 201 201 201 201 201 201 201 483 201 201 201 201 201 201 201 216 216 231 231
231 231 216 216 201 201 201 201 201 201 201 201 201 201 201 201 201 201 201 201 201 201 483 201 201 201 201 201 201 201 216 216 231 231
231 231 216 216 201 201 201 201 201 201 201 201 201 201 201 201 201 201 201 201 201 201 483 201 201 227 201 201 201 201 216 216 231 231
231 231 216 216 216 216 201 201 216 216 216 216 216 216 216 216 216 216 216 216 216 216 216 216 216 216 216 216 201 201 216 216 231 231
231 231 216 216 216 216 225 225 216 216 216 216 216 216 216 216 216 216 216 216 216 216 216 216 216 216 216 216 225 225 216 216 231 231
231 231 231 231 231 231 231 231 231 231 231 231 231 231 231 231 231 231 231 231 231 231 231 231 231 231 231 231 231 231 231 231 231 231
231 231 231 231 231 231 231 231 231 231 231 231 231 231 231 231 231 231 231 231 231 231 231 231 231 231 231 231 231 231 231 231 231 231
82
82
82
82
82
231 231 231 231 231 231 231 231 231 231 231 231 231 231 231 231 231 231 231 231 231 231 231 231 231 231 231 231 231 231 231 231 231 231
231 231 231 231 231 231 231 231 231 231 231 231 231 231 231 231 231 231 231 231 231 231 231 231 231 231 231 231 231 231 231 231 231 231
231 231 216 216 216 216 216 216 216 216 216 216 219 233 233 233 233 233 233 233 233 221 216 216 216 216 216 216 216 216 216 216 231 231
231 231 216 216 216 216 216 216 216 216 216 216 215 224 224 224 224 224 224 224 224 218 216 216 216 216 216 216 216 216 216 216 231 231
231 231 216 216 201 201 227 201 201 201 201 201 215 224 224 224 224 224 224 224 224 218 201 201 201 201 201 201 201 201 216 216 231 231
231 231 216 216 201 201 201 201 201 201 201 201 215 224 224 224 224 222 216 230 216 217 201 201 201 201 201 228 201 201 216 216 231 231
231 231 216 216 201 201 219 220 220 220 220 221 215 224 224 224 224 218 201 201 201 201 483 201 201 201 201 201 201 201 216 216 231 231
231 231 216 216 201 201 215 224 224 228 224 218 215 224 224 224 224 218 201 201 201 201 483 201 201 201 201 201 201 201 216 216 231 231
231 231 216 216 201 201 215 224 224 224 224 218 215 224 224 224 224 218 201 201 728 201 483 201 201 728 201 201 201 201 216 216 231 231
231 231 216 216 201 201 215 224 224 222 216 217 215 224 224 227 224 218 201 201 201 201 483 201 201 201 201 201 201 201 216 216 231 231
231 231 216 216 201 201 215 224 224 218 219 233 224 224 224 224 224 218 201 201 201 201 483 201 201 201 201 201 201 201 216 216 231 231
231 231 216 216 201 201 214 230 216 217 215 224 224 224 224 224 224 218 201 201 201 201 483 483 483 483 483 483 483 483 216 216 231 231
231 231 216 216 201 201 201 201 201 201 215 224 224 224 224 224 224 224 220 220 220 221 201 201 201 201 201 201 201 201 216 216 231 231
231 231 216 216 201 201 201 201 201 201 215 224 224 224 224 224 224 224 224 224 224 218 201 201 201 201 201 227 201 201 216 216 231 231
231 231 216 216 201 201 201 201 201 201 215 224 224 224 224 224 224 224 224 224 224 218 201 201 201 201 201 201 201 201 216 216 231 231
231 231 216 216 201 201 201 201 201 201 214 230 216 216 216 216 216 216 216 230 216 217 201 201 201 201 201 201 201 201 216 216 231 231
231 231 216 216 201 201 201 201 201 201 201 201 201 201 483 201 201 201 201 201 201 201 483 201 201 201 201 201 201 201 216 216 231 231
231 231 216 216 201 201 201 201 201 201 201 201 201 201 483 201 201 201 201 201 201 227 483 201 201 228 201 201 201 201 216 216 231 231
231 231 216 216 216 216 216 216 216 216 216 216 216 216 216 216 216 216 216 216 216 216 216 216 216 216 216 216 216 216 216 216 231 231
231 231 216 216 216 216 216 216 216 216 216 216 216 216 216 216 216 216 216 216 216 216 216 216 216 216 216 216 216 216 216 216 231 231
231 231 231 231 231 231 231 231 231 231 231 231 231 231 231 231 231 231 231 231 231 231 231 231 231 231 231 231 231 231 231 231 231 231
231 231 231 231 231 231 231 231 231 231 231 231 231 231 231 231 231 231 231 231 231 231 231 231 231 231 231 231 231 231 231 231 231 231
82
82
82
82
82
231 231 231 231 231 231 231 231 231 231 231 231 231 231 231 231 231 231 231 231 231 231 231 231 231 231 231 231 231 231 231 231 231 231
231 231 231 231 231 231 231 231 231 231 231 231 231 231 231 231 231 231 231 231 231 231 231 231 231 231 231 231 231 231 231 231 231 231
231 231 216 216 216 216 216 216 216 216 216 216 216 216 216 216 216 216 216 216 216 216 216 216 216 216 216 216 216 216 216 216 231 231
231 231 216 216 216 216 216 216 216 216 216 216 216 216 216 216 216 216 216 216 216 216 216 216 216 216 216 216 216 216 216 216 231 231
231 231 216 216 201 201 201 201 201 201 201 201 201 201 201 201 201 201 201 201 201 201 201 201 219 233 233 233 233 221 216 216 231 231
231 231 216 216 201 201 201 228 201 201 201 201 201 201 201 201 201 201 201 201 201 201 201 201 215 224 224 227 224 218 216 216 231 231
231 231 216 216 201 201 201 201 201 201 201 201 219 220 220 220 220 221 201 201 201 201 201 201 215 224 224 224 224 218 216 216 231 231
231 231 216 216 201 201 201 201 201 201 201 201 215 224 224 224 224 218 201 201 201 201 201 201 214 216 216 230 216 217 216 216 231 231
231 231 216 216 201 201 201 201 201 201 201 201 215 224 224 224 224 218 201 201 201 728 483 483 728 201 201 201 201 201 216 216 231 231
231 231 216 216 201 201 201 201 201 201 201 201 215 224 224 228 224 218 201 201 201 201 483 483 201 201 201 201 201 201 216 216 231 231
231 231 216 216 219 220 220 220 220 220 220 220 224 224 224 224 224 224 220 220 220 220 220 221 201 201 201 201 201 201 216 216 231 231
231 231 216 216 215 224 224 224 224 224 224 224 224 224 224 224 224 224 224 224 224 224 224 218 201 201 201 201 201 201 216 216 231 231
231 231 216 216 215 224 224 224 224 224 224 224 224 224 224 224 224 224 224 224 224 224 224 218 219 220 220 220 220 221 216 216 231 231
231 231 216 216 214 216 216 216 230 230 216 216 216 216 216 216 223 224 224 224 224 224 224 218 215 224 224 228 224 218 216 216 231 231
231 231 216 216 201 201 201 201 201 201 201 201 201 201 201 201 215 224 224 224 224 224 224 218 215 224 224 224 224 218 216 216 231 231
231 231 216 216 201 201 201 227 201 201 201 201 201 201 201 201 214 216 216 230 216 216 216 217 215 224 224 224 224 218 216 216 231 231
231 231 216 216 201 201 201 201 201 201 201 201 201 201 201 201 201 201 201 201 201 201 201 201 215 224 224 227 224 218 216 216 231 231
231 231 216 216 201 201 201 201 201 201 201 201 201 201 201 201 201 231 201 201 201 228 201 201 214 216 216 216 216 217 216 216 231 231
231 231 216 216 216 216 216 216 216 216 216 216 216 216 216 216 216 216 216 216 216 216 216 216 216 216 216 216 216 216 216 216 231 231
231 231 216 216 216 216 216 216 216 216 216 216 216 216 216 216 216 216 216 216 216 216 216 216 216 216 216 216 216 216 216 216 231 231
231 231 231 231 231 231 231 231 231 231 231 231 231 231 231 231 231 231 231 231 231 231 231 231 231 231 231 231 231 231 231 231 231 231
231 231 231 231 231 231 231 231 231 231 231 231 231 231 231 231 231 231 231 231 231 231 231 231 231 231 231 231 231 231 231 231 231 231
82
82
82
82
82
231 231 231 231 231 231 231 231 231 231 231 231 231 231 231 231 231 231 231 231 231 231 231 231 231 231 231 231 231 231 231 231 231 231
231 231 231 231 231 231 231 231 231 231 231 231 231 231 231 231 231 231 231 231 231 231 231 231 231 231 231 231 231 231 231 231 231 231
231 231 219 233 233 233 233 233 233 233 233 221 209 213 209 213  81  81 209 213 209 213 219 233 233 233 233 233 233 233 233 217 231 231
231 231 215 224 224 224 224 224 224 224 224 218 208 212 208 212  81  81 208 212 208 212 215 224 224 224 224 224 224 224 224 218 231 231
231 231 215 224 224 224 224 224 224 224 224 218  81  81  81  81  81  81  81  81  81  81 215 224 224 224 224 224 224 224 224 218 231 231
231 231 215 224 224 224 224 224 224 224 224 218  81  81  81  81  81  81  81  81  81  81 215 224 224 224 224 228 224 224 224 218 231 231
231 231 215 224 224 224 224 224 224 224 224 218 219 220 220 220 220 220 220 221  81  81 215 224 224 224 224 227 224 224 224 218 231 231
231 231 215 224 224 224 224 222 230 230 216 217 215 224 224 224 224 224 224 218  81  81 214 216 216 216 216 216 216 216 216 217 231 231
231 231 215 224 224 224 224 218 201 201 227 201 215 224 224 224 224 224 224 218  81  81 219 233 233 233 233 233 233 233 233 221 231 231
231 231 215 224 224 224 224 218 201 201 201 201 215 224 224 222 216 230 216 217  81  81 215 224 224 224 224 224 224 224 224 218 231 231
231 231 215 224 224 224 224 224 220 220 220 220 224 224 224 218  81  81  81  81  81  81 215 224 224 224 224 224 224 224 224 218 231 231
231 231 215 224 224 224 224 224 224 224 224 224 224 224 224 218  81  81  81  81  81  81 214 216 216 230 223 224 224 224 224 218 231 231
231 231 215 224 224 224 224 224 224 224 224 224 224 224 224 218  81  81  81  81  81  81  81  81  81  81 215 224 224 224 224 218 231 231
231 231 215 224 224 224 224 224 224 222 216 216 223 224 224 218  81  81  81  81  81  81  81  81  81  81 215 224 224 224 224 218 231 231
231 231 215 224 224 224 224 228 224 218 201 201 215 224 224 224 220 220 220 220 220 221  81  81 219 220 224 224 224 224 224 218 231 231
231 231 214 216 216 216 216 216 216 217 201 201 215 224 224 224 224 224 224 224 224 218  81  81 215 224 224 224 224 224 224 218 231 231
231 231 201 201 201 201 201 201 201 231 201 201 215 224 224 224 224 224 224 224 224 218  81  81 215 224 224 228 224 224 224 218 231 231
231 231 201 201 201 201 231 201 201 201 201 201 214 216 216 216 216 216 230 230 216 217  81  81 214 216 216 216 216 216 216 217 231 231
231 231 201 201 201 728 231 201 728 201 201 231 201 201 201 201 201 201 201 201 483 483  81  81 483 201 201 201 201 201 201 201 231 231
231 231 201 201 201 201 231 201 201 201 201 201 201 201 201 201 201 201 201 201 201 483  81  81 483 201 201 201 201 201 201 201 231 231
231 231 231 231 231 231 231 231 231 231 231 231 231 231 231 231 231 231 231 231 231 231 231 231 231 231 231 231 231 231 231 231 231 231
231 231 231 231 231 231 231 231 231 231 231 231 231 231 231 231 231 231 231 231 231 231 231 231 231 231 231 231 231 231 231 231 231 231
82
82
82
82
82
231 231 231 231 231 231 231 231 231 231 231 231 231 231 231 231 231 231 231 231 231 231 231 231 231 231 231 231 231 231 231 231 231 231
231 231 231 231 231 231 231 231 231 231 231 231 231 231 231 231 231 231 231 231 231 231 231 231 231 231 231 231 231 231 231 231 231 231
231 231 216 216  81  81 219 233 233 233 233 233 233 221  81  81 219 233 233 233 233 233 233 233 233 233 233 233 233 221 216 216 231 231
231 231 216 216  81  81 215 224 224 224 224 224 224 218  81  81 215 224 224 224 224 224 224 224 224 226 224 224 224 218 216 216 231 231
231 231 216 216  81  81 215 224 224 224 224 224 224 218  81  81 215 224 224 224 224 224 224 224 224 224 224 224 224 218 216 216 231 231
231 231 216 216  81  81 214 216 216 230 216 216 216 217  81  81 215 224 224 224 224 224 224 224 224 224 224 224 224 218 216 216 231 231
231 231 216 216  81  81  81  81  81  81  81  81  81  81  81  81 215 224 224 224 224 224 224 224 224 224 224 228 224 218 216 216 231 231
231 231 216 216  81  81  81  81  81  81  81  81  81  81  81  81 215 224 224 222 216 216 216 216 216 230 216 216 216 217 216 216 231 231
231 231 216 216  81  81  81  81 219 220 220 220 220 220 220 220 224 224 224 218  81  81  81  81  81  81  81  81  81  81 216 216 231 231
231 231 216 216  81  81  81  81 215 224 224 224 224 228 224 224 224 224 224 218  81  81  81  81  81  81  81  81  81  81 216 216 231 231
231 231 216 216  81  81  81  81 215 224 224 224 224 224 224 224 224 224 224 218  81  81  81  81  81  81  81  81  81  81 216 216 231 231
231 231 216 216  81  81  81  81 215 224 224 224 224 224 224 224 224 222 216 217  81  81  81  81  81  81  81  81  81  81 216 216 231 231
231 231 216 216  81  81  81  81 215 224 224 224 224 224 224 224 224 218  81  81  81  81  81  81  81  81  81  81  81  81 216 216 231 231
231 231 216 216  81  81  81  81 214 230 216 216 216 216 223 224 224 218  81  81  81  81  81  81  81  81  81  81  81  81 216 216 231 231
231 231 216 216  81  81  81  81  81  81  81  81  81  81 215 224 224 218  81  81  81  81  81  81  81  81  81  81  81  81 216 216 231 231
231 231 216 216  81  81  81  81  81  81  81  81  81  81 215 224 224 218  81  81  81  81  81  81  81  81  81  81  81  81 216 216 231 231
231 231 216 216  81  81  81  81 219 220 220 220 220 220 224 224 224 224 220 220 220 221  81  81  81  81  81  81  81  81 216 216 231 231
231 231 216 216  81  81  81  81 215 224 224 226 224 224 224 224 224 224 224 224 224 218  81  81  81  81  81  81  81  81 216 216 231 231
231 231 216 216 209 213  81  81 215 224 224 224 224 224 224 224 224 224 224 224 224 218  81  81 209 213 483 201 209 213 216 216 231 231
231 231 216 216 208 212  81  81 214 216 216 216 216 216 216 216 216 216 216 216 216 217  81  81 208 212 483 483 208 212 216 216 231 231
231 231 231 231 231 231 231 231 231 231 231 231 231 231 231 231 231 231 231 231 231 231 231 231 231 231 231 231 231 231 231 231 231 231
231 231 231 231 231 231 231 231 231 231 231 231 231 231 231 231 231 231 231 231 231 231 231 231 231 231 231 231 231 231 231 231 231 231