NAME
Saffron Pok{e-accent}center
NPCS
saffron-center-joy joy 3 1
INTERACTIONS
MENU:ALERT:ERROR
END
TELEPORT
10 18 saffron-city 27 29
11 18 saffron-city 27 29
24 0 silph-co 24 25
24 24 silph-co 24 1
26 24 silph-co 26 48
26 47 silph-co 26 25
24 47 silph-co 24 71
24 70 silph-co 24 48
26 70 silph-co 26 94
26 93 silph-co 26 71
24 93 silph-co 20 117
20 116 silph-co 24 94
22 116 silph-co 22 140
22 139 silph-co 22 117
20 139 silph-co 20 163
20 162 silph-co 20 140
22 162 silph-co 22 186
22 185 silph-co 22 163
DATA
614 635 635 635 635 635 636 635 635 635 635 635 635 635 635 635 635 635 635 635 620 635 635 635 523 635 635 635 635 614
599 600 600 600 600 600 485 600 600 600 600 600 600 600 600 600 600 600 600 600 600 600 600 600 600 600 600 600 600 599
599 600 600 600 600 600 485 600 600 600 600 600 600 600 600 600 600 600 600 600 600 600 600 600 600 600 600 501 600 599
599 486 486 486 486 486 637 600 600 600 600 600 607 607 600 600 600 600 607 607 600 600 600 600 600 600 600 500 600 599
599 600 600 600 600 600 600 600 600 600 600 607  81  81 607 600 600 607  81  81 607 600 600 600 600 600 600 600 600 599
599 600 600 600 600 600 600 600 600 600 607 607  81  81 607 607 607 607  81  81 607 607 600 600 600 600 600 600 600 599
599 600 501 600 600 600 600 600 600 607  81  81  81  81  81  81  81  81  81  81  81  81 607 600 600 600 600 501 600 599
599 600 500 600 600 600 600 600 600 607  81  81  81  81  81  81  81  81  81  81  81  81 607 600 600 600 600 500 600 599
599 600 600 600 600 600 600 600 600 600 607 607  81  81 607 607 607 607  81  81 607 607 600 600 600 600 600 600 600 599
599 600 600 600 600 600 600 600 600 600 600 607  81  81 607 600 600 607  81  81 607 600 600 600 600 600 600 600 600 599
599 600 501 600 600 600 600 600 600 600 600 600 607 607 600 600 600 600 607 607 600 600 600 600 600 600 600 501 600 599
599 600 500 600 600 600 600 600 600 600 600 600 600 600 600 600 600 600 600 600 600 600 600 600 600 600 600 500 600 599
599 600 600 600 600 600 600 600 600 600 600 600 600 600 600 600 600 600 600 600 600 600 600 600 600 600 600 600 600 599
599 600 600 600 600 600 600 600 600 600 600 600 600 600 600 600 600 600 600 600 600 600 600 600 600 600 600 600 600 599
599 600 501 501 501 501 501 501 600 600 600 600 600 600 600 600 600 600 600 600 600 600 501 501 501 501 501 501 600 599
599 600 500 500 500 500 500 500 600 600 600 600 600 600 600 600 600 600 600 600 600 600 500 500 500 500 500 500 600 599
599 600 600 600 600 600 600 600 600 600 600 600 600 600 600 600 600 600 600 600 600 600 600 600 600 600 600 600 600 599
596 597 597 597 597 597 597 597 597 598 603 605 596 597 597 597 597 597 597 597 597 597 597 597 597 597 597 597 597 598
82   82  82  82  82  82  82  82  82  82 166 166
82
82
82
82
82
594 597 615 615 615 615 615 615 615 615 597 595 635 635 635 635 635 635 635 635 620 635 635 635 489 635 523 635 635 614
599 600 617 617 617 617 617 617 617 617 600 599 600 600 600 600 600 600 600 600 600 600 600 600 600 600 600 600 600 599
599 600 600 600 600 600 600 600 600 600 600 599 600 600 600 600 600 600 600 600 600 600 600 600 600 600 600 600 600 599
599 600 600 638 600 600 600 600 600 600 600 599 600 600 600 600 600 600 600 600 600 600 600 600 600 600 600 600 600 599
594 597 597 598 600 600 596 597 615 615 615 615 615 615 615 615 615 615 615 615 597 597 597 598 600 600 596 597 597 595
599 600 600 600 600 600 600 600 617 617 617 617 617 617 617 617 617 617 617 617 600 600 600 600 600 600 600 600 600 599
599 600 600 600 600 600 600 600 600 600 600 600 600 600 600 600 600 600 600 600 600 600 600 600 600 600 600 600 600 599
599 600 600 600 600 600 600 600 600 600 600 600 600 600 600 600 600 600 600 600 600 600 600 600 600 600 600 600 600 599
599 600 600 600 600 600 600 600 600 600 600 600 600 600  48 606 600 600  48 606 600 501 594 597 615 615 615 615 615 595
599 600 600 600 600 600 600 600 600 600 600 600 600 600 567 639 600 600 567 639 600 500 599 600 617 617 617 617 616 599
594 597 597 598 600 600 596 597 597 597 597 595 600 600 567 639 600 600 567 639 600 501 599 600 600 600 600 600 616 599
599 600 600 600 600 600 600 600 600 600 600 599 600 600 567 639 600 600 567 639 600 500 613 600 600 600 600 600 617 599
599 600  48 606 600 600 501 501 501 501 600 599 600 600 567 639 600 600 567 639 600 600 600 600 600 600 600 600 600 599
599 600 567 639 600 600 500 500 500 500 600 599 600 600 567 639 600 600 567 639 600 600 600 600 600 600 600 600 600 599
599 600 601 602 600 600 600 600 600 600 600 599 600 600 601 602 600 600 601 602 600 600 614 600  48 606 600 600 600 599
599 600 600 600 600 600 600 600 600 638 600 599 600 600 600 600 600 600 600 600 600 600 599 600 601 602 600 638 600 599
599 600 600 600 600 600 600 600 600 600 600 599 600 600 600 600 600 600 600 600 600 600 599 600 600 600 600 600 600 599
596 597 597 597 597 597 597 597 597 597 597 598 597 597 597 597 597 597 597 597 597 597 596 597 597 597 597 597 597 598
82
82
82
82
82
614 635 635 635 635 635 635 635 635 635 635 635 635 635 635 635 635 635 635 635 620 635 635 635 523 635 489 635 635 614
599 600 600 600 600 600 600 600 600 600 600 600 600 600 600 600 600 600 600 600 600 600 600 600 600 600 600 600 600 599
599 600 600 600 600 600 600 600 600 600 600 600 600 600 600 600 600 600 600 600 600 600 600 600 600 600 600 600 600 599
599 600 600 638 600 600 600 600 600 600 600 600 600 600 600 600 600 600 600 600 600 600 600 600 600 600 600 638 600 599
594 615 615 615 615 615 597 597 597 595 615 615 597 597 615 615 597 595 600 600 600 614 615 615 615 615 615 615 615 595
599 616 617 617 617 617 600 600 600 599 617 617 600 600 617 617 600 599 600 600 600 599 617 617 617 617 617 617 616 599
599 616 600 600 600 600 600 600 600 599 600 600 600 600 600 600 600 599 600 600 600 599 600 600 600 600 600 600 616 599
599 617 600 600  48 606 600 600 600 613 600 600 600 600 600 600 600 613 600 600 600 613 600 600 600 600 600 600 617 599
599 600 600 600 567 639 600 600 600 600 600 600  48 606 600 600 600 600 600 600 600 600 600 600 600 600  48 606 600 599
599 600 600 600 567 639 600 600 600 600 600 600 601 602 600 600 600 600 600 600 600 600 600 600 600 600 601 602 600 599
599 600 600 600 601 602 600 600 600 614 600 600 600 600 600 600 600 614 600 600 600 614 600 600  27 600  27 600 600 599
599 600 600 638 600 600 600 600 600 599 600 638 600 600 600 600 600 599 600 600 600 599 600 638  28 600  28 600 600 599
599 600 600 600 600 600 600 600 600 599 600 600 600 600 600 600 600 599 600 600 600 599 600 600 600 600 600 600 600 599
599 597 597 597 597 597 597 597 597 598 597 597 597 597 597 597 597 598 600 600 600 613 597 597 597 597 597 597 597 599
599 600 600 600 600 600 600 600 600 600 600 600 600 600 600 600 600 600 600 600 600 600 600 600 600 600 600 600 600 599
599 600 600 638 600 600 600 600 600 600 600 600 600 600 600 600 600 600 600 600 600 600 600 600 600 600 600 638 600 599
599 600 600 600 600 600 600 600 600 600 600 600 600 600 600 600 600 600 600 600 600 600 600 600 600 600 600 600 600 599
596 597 597 597 597 597 597 597 597 597 597 597 597 597 597 597 597 597 597 597 597 597 597 597 597 597 597 597 597 598
82
82
82
82
82
614 635 635 635 635 635 635 635 635 614 615 615 615 615 615 615 615 615 614 635 620 635 635 635 489 635 523 635 635 614
599 600 600 600 600 600 600 600 600 599 617 617 617 617 617 617 617 617 599 600 600 600 600 600 600 600 600 600 600 599
599 600 607 607 607 607 600 607 600 599 600 600 600 600 600 600 600 600 599 600 600 600 600 600 600 600 600 600 600 599
599 600 607 607 607 607 607 607 600 599 600 600 600 600 600 600 600 638 599 600 600 600 600 600 600 600 600 600 600 599
599 600 607 607 607 607 607 607 600 599 600 600  48 606  48 606 600 600 599 600 594 597 597 598 600 600 596 597 597 595
599 600 607 607 607 607 607 607 600 599 600 600 601 602 601 602 600 600 599 600 599 600 600 600 600 600 600 600 600 599
599 600 607 607 607 607 607 607 600 599 600 600 600 600 600 600 600 600 599 600 599 600 501 600 600 600 600 501 600 599
599 600 607 607 600 607 607 607 600 599 600 638 600 600 600 600 600 600 599 600 599 600 500 600  48 606 600 500 600 599
599 600 607 607 600 600 607 607 600 599 597 598 600 600 596 597 615 615 599 600 599 600 600 600 567 639 600 600 600 599
599 600 607 600 600 600 607 607 600 599 600 600 600 600 600 600 617 617 599 600 599 600 600 600 567 639 600 600 600 599
599 600 600 600 600 600 600 600 600 599 600 600 600 600 600 600 600 600 599 600 599 600 501 600 567 639 600 501 600 599
599 600 600 600 600 600 600 600 600 599 600 600 600 600 600 600 600 638 599 600 599 600 500 600 567 639 600 500 600 599
594 597 597 598 600 600 596 597 597 597 597 598 600 600 596 597 597 597 613 600 599 600 600 600 567 639 600 600 600 599
599 600 600 600 600 600 600 600 600 600 600 600 600 600 600 600 600 600 600 600 599 600 600 600 567 639 600 600 600 599
599 600 600 600 600 600 600 600 600 600 600 600 600 600 600 600 600 600 600 600 599 600 501 600 601 602 600 501 600 599
599 600 600 638 600 600 600 600 600 600 600 600 600 600 600 600 600 600 600 600 599 600 500 600 600 600 600 500 600 599
599 600 600 600 600 600 600 600 600 600 600 600 600 600 600 600 600 600 600 600 599 600 600 600 600 600 600 600 600 599
596 597 597 597 597 597 597 597 597 597 597 597 597 597 597 597 597 597 597 597 596 597 597 597 597 597 597 597 597 598
82
82
82
82
82
594 597 615 615 615 615 597 595 635 635 635 635 635 635 635 635 635 635 635 635 620 635 635 635 523 635 489 635 635 614
599 600 617 617 617 617 600 599 600 600 600 600 600 600 600 600 600 600 600 600 600 600 600 600 600 600 600 600 600 599
599 600 600 600 600 600 600 599 600 600 600 501 501 600 600 600 600 600 600 600 600 600 600 600 600 600 600 600 600 599
599 600 600 600 600 600 600 613 600 600 600 500 500 600 600 600 600 600 600 600 600 600 600 600 600 600 600 638 600 599
599 600 600 600 600 600 600 600 600 600 600 600 600 600 600 614 597 597 597 597 597 598 600 600 596 597 597 595 600 599
599 600 600 600 600 600 600 600 600 600 600 638 600 600 600 599 600 600 600 600 600 600 600 600 600 600 600 599 600 599
599 600 600 600 600 600 600 614 600 600 594 615 615 615 597 595 600 600 600 600  48 606  48 606  48 606 600 599 600 599
599 600 600 600 600 600 600 599 600 600 599 616 617 617 600 599 600 600 600 600 601 602 601 602 567 639 600 599 600 599
599 600 600 600 600 600 600 599 600 600 599 616 600 600 600 599 600 600 600 600 600 600 600 600 567 639 600 599 600 599
599 596 597 597 597 597 598 599 600 600 599 617 600 600 600 613 600 600 600 600 600 600 600 600 567 639 600 599 600 599
599 600 600 600 600 600 600 599 600 600 599 600 600 600 600 600 600 600 600 600 600 600 600 600 567 639 600 599 600 599
599 600 600 600 600 600 600 613 600 600 599 600 600 600 600 600 600 600 600 600 600 600 600 600 567 639 600 599 600 599
599 600 607 607 607 607 600 600 600 600 599 600 600 600 600 614 600 600 600 600  48 606  48 606  48 606 600 599 600 599
599 600 600 607 607 607 600 600 600 600 599 600 600 600 600 599 600 600 600 600 601 602 601 602 601 602 600 599 600 599
599 600 600 600 607 607 600 614 600 638 599 600 600 600 600 599 600 600 600 600 600 600 600 600 600 600 600 599 600 599
599 600 600 638 607 607 600 599 600 600 596 597 597 597 597 598 597 597 597 597 597 597 597 597 597 597 597 598 600 599
599 600 600 600 600 600 600 599 600 600 600 600 600 600 600 600 600 600 600 600 600 600 600 600 600 600 600 600 600 599
596 597 597 597 597 597 597 598 597 597 597 597 597 597 597 597 597 597 597 597 597 597 597 597 597 597 597 597 597 598
82
82
82
82
82
594 615 615 615 597 595 635 635 635 635 635 635 635 635 635 635 620 635 635 635 489 635 523 635 635 614
599 616 617 617 600 599 600 600 600 600 600 600 600 600 600 600 600 600 600 600 600 600 600 600 600 599
599 616 600 600 600 599 600 600 600 600 600 600 600 600 600 600 600 600 600 600 600 600 600 600 600 599
599 617 600 638 600 613 600 600 600 600 600 600 600 600 600 600 600 600 600 600 600 600 600 638 600 599
599 600 600 600 600 600 600 600 594 615 615 615 597 597 597 597 597 598 600 600 596 597 597 595 600 599
599 600 600 600 600 600 600 600 599 616 617 617 600 600 600 600 600 600 600 600 600 600 600 599 600 599
599 501 600 600 501 614 600 600 599 616 600 600 600 600 600 600 600 600 600 600 600 600 600 599 600 599
599 500 600 600 500 599 600 600 599 617 600 600  48 606  48 606  48 606  48 606  48 606 600 599 600 599
594 597 597 597 597 595 600 600 599 600 600 600 567 639 601 602 601 602 601 602 567 639 600 599 600 599
599 600 600 600 600 599 600 600 599 600 600 600 567 639 600 600 600 600 600 600 567 639 600 599 600 599
599 600 607 607 600 599 600 600 599 501 600 600 567 639 600 600 600 600 600 600 567 639 600 599 600 599
599 600 607 600 600 613 600 600 599 500 600 600 567 639  48 606  48 606  48 606 567 639 600 599 600 599
599 600 607 600 600 600 600 600 599 501 600 600 601 602 601 602 601 602 601 602 601 602 600 599 600 599
599 600 607 607 600 600 600 600 599 500 600 600 600 600 600 600 600 600 600 600 600 600 600 599 600 599
599 600 607 607 600 614 600 600 596 597 597 598 600 600 596 597 597 597 597 597 597 597 597 598 600 599
599 600 600 607 600 599 600 600 600 600 600 600 600 600 600 600 600 600 600 600 600 600 600 600 600 599
599 600 600 600 600 599 600 600 600 600 600 600 600 600 600 600 600 600 600 600 600 600 600 600 600 599
596 597 597 597 597 598 597 597 597 597 597 597 597 597 597 597 597 597 597 597 597 597 597 597 597 598
82
82
82
82
82
594 597 597 597 615 615 594 615 597 597 597 597 597 597 597 595 620 635 635 635 523 635 489 635 635 614
599 600 600 600 617 617 599 616 600 600 600 600 616 600 600 599 600 600 600 600 600 600 600 600 600 599
599 600 600 600 600 600 599 616 600 600 600 600 485 600 600 613 600 600 600 600 600 600 600 600 600 599
599 600 600 600 600 638 599 617 486 486 486 486 637 600 600 600 600 600 600 600 600 600 600 600 600 599
599 600 600 600  48 606 599 600 600 600 600 600 600 600 501 614 600 614 597 598 600 600 596 597 597 595
599 600 600 600 601 602 599 600 600 600 600 600 600 600 500 599 600 599 600 600 600 600 600 600 600 599
599 600 600 600 600 600 594 597 597 598 600 600 596 597 597 595 600 599 501 600 600 600 600 600 600 599
599 600 600 600 600 638 599 600 600 600 600 600 600 600 600 599 600 599 500 600 600 600  48 606 600 599
594 597 615 615 615 615 599 600 600 600 600 600 600 600 600 599 600 599 501 600 600 600 567 639 600 599
599 600 617 617 617 617 599 600  48 606 600 600  48 606 600 599 600 599 500 600 600 600 567 639 600 599
599 600 600 600 600 600 599 600 567 639 600 600 567 639 600 599 600 599 501 600 600 600 601 602 600 599
599 600 600 600 600 600 599 600 567 639 600 600 567 639 600 599 600 599 500 600 600 600 600 600 600 599
599 600 600 501 501 600 599 600 601 602 600 600 601 602 600 599 600 599 597 597 600 600 596 597 597 595
599 600 600 500 500 600 599 600 600 600 600 600 600 600 600 599 600 599 600 600 600 600 600 600 600 599
599 600 600 600 600 600 599 600 600 600 600 600 600 600 600 599 600 599 600 600 600 600 600 600 600 599
599 600 600 600 600 600 596 597 597 597 597 597 597 597 597 598 600 599 600 600 600 638 600 600 600 599
599 600 600 600 600 600 600 600 600 600 600 600 600 600 600 600 600 599 600 600 600 600 600 600 600 599
596 597 597 597 597 597 597 597 597 597 597 597 597 597 597 597 597 598 596 597 597 597 597 597 597 598
82
82
82
82
82
594 597 597 597 597 597 597 595 615 615 615 615 615 595 635 635 620 635 635 635 489 635 523 635 635 614
599 600 600 600 600 600 600 599 617 617 617 617 616 599 600 600 600 600 600 600 600 600 600 600 600 599
599 600 600 600 600 600 600 599 600 600 600 600 616 599 600 600 600 600 600 600 600 600 600 600 600 599
599 600  48 606  48 606 600 599 600 600 600 600 617 599 600 600 600 600 600 600 600 600 600 600 600 599
599 600 567 639 567 639 600 599 600 600 600 600 600 599 600 600 594 597 597 597 597 597 597 597 597 595
599 600 567 639 567 639 600 599 600 600 600 638 600 599 600 600 599 600 600 600 600 600 600 600 600 599
599 600 567 639 567 639 600 599 600 600 600 600 600 599 600 600 599 600  27 600  27 600 600 501 600 599
599 600 567 639 567 639 600 613 600 600 596 597 597 599 600 600 599 600  28 600  28 600 600 500 600 599
599 600 601 602 567 639 600 600 600 600 600 600 600 599 600 600 599 600 600 600 600 600 600 600 600 599
599 600 600 600 567 639 600 600 600 600 600 638 600 599 600 600 599 600 600 600 600 600 600 600 600 599
599 600 600 600 601 602 600 614 600 600  48 606 600 599 600 600 599 600  48 606 600 600 600 501 600 599
599 600 600 638 600 600 600 599 600 600 601 602 600 599 600 600 599 600 601 602 600 600 600 500 600 599
599 600 600 600 600 600 600 599 600 600 600 600 600 599 600 600 599 600 600 600 600 600 600 600 600 599
599 597 597 597 597 597 597 598 600 600 596 597 597 598 600 600 596 597 597 598 600 600 596 597 597 599
599 501 600 600 600 600 600 600 600 600 600 600 600 600 600 600 600 600 600 600 600 600 600 600 600 599
599 500 600 638 600 600 600 600 600 600 600 600 600 600 600 600 600 600 600 600 600 600 600 600 600 599
599 600 600 600 600 600 600 600 600 600 600 600 600 600 600 600 600 600 600 600 600 600 600 600 600 599
596 597 597 597 597 597 597 597 597 597 597 597 597 597 597 597 597 597 597 597 597 597 597 597 597 598
82
82
82
82
82
594 597 597 597 597 597 597 597 597 597 597 595 635 635 635 635 620 635 635 635 523 635 489 635 635 614
599 600 600 600 600 600 600 600 600 600 600 599 600 600 600 600 600 600 600 600 600 600 600 600 600 599
599 600 600 600 600 600 600 600 600 600 600 599 600 600 600 600 600 600 600 600 600 600 600 600 600 599
599 600 600 600 600 600 600 600 600 638 600 599 600 600 600 600 600 600 600 600 600 600 600 600 600 599
599 600 600 614 597 597 597 597 597 597 597 595 600 600 594 597 597 598 600 600 596 597 614 600 600 599
599 600 600 599 600 600 600 600 600 600 600 599 600 600 599 600 600 600 600 600 600 600 599 600 600 599
599 600 600 599 600 600  48 606  48 606 600 599 600 600 599 600 600 600 600 600 600 600 599 501 600 599
599 600 600 613 600 600 601 602 601 602 600 599 600 600 599 600 600 600  48 606 600 600 599 500 600 599
599 600 600 600 600 600 596 597 594 597 597 595 501 600 599 600 600 600 601 602 600 600 599 501 600 599
599 600 600 600 600 600 600 600 599 600 600 599 500 600 599 600 600 600 600 600 600 600 599 500 600 599
599 600 600 614 600 600 600 600 599 600 600 599 501 600 594 597 597 598 600 600 596 597 597 595 600 599
599 600 600 599 600 600 600 600 613 600 600 613 500 600 599 600 600 600 600 600 600 600 600 599 600 599
599 600 600 599  27 600  27 600 600 600 600 600 600 600 599 600  48 606  48 606 600 600 600 599 600 599
599 597 597 598  28 600  28 600 600 600 600 600 600 600 599 600 601 602 567 639 600 600 600 613 600 599
599 600  27 600  27 600  27 600 614 600 600 614 600 600 599 600 600 600 567 639 600 600 600 600 600 599
599 600  28 600  28 600  28 600 599 600 600 599 600 600 599 600 600 638 601 602 600 600 600 600 600 599
599 600 600 600 600 600 600 600 599 600 600 599 600 600 599 600 600 600 600 600 600 600 600 600 600 599
596 597 597 597 597 597 597 597 596 597 597 598 597 597 596 597 597 597 597 597 597 597 597 597 597 598