NAME
Saffron Pok{e-accent}center
NPCS
saffron-center-joy joy 3 1
INTERACTIONS
MENU:ALERT:ERROR
END
TELEPORT
10 18 saffron-city 27 29
11 18 saffron-city 27 29
26 0 silph-co 24 25
24 24 silph-co 26 1
DATA
614 635 635 635 635 635 636 635 635 635 635 635 635 635 635 635 635 635 635 635 620 635 635 635 635 635 523 635 635 614
599 600 600 600 600 600 485 600 600 600 600 600 600 600 600 600 600 600 600 600 600 600 600 600 600 600 600 600 600 599
599 600 600 600 600 600 485 600 600 600 600 600 600 600 600 600 600 600 600 600 600 600 600 600 600 600 600 501 600 599
599 486 486 486 486 486 637 600 600 600 600 600 607 607 600 600 600 600 607 607 600 600 600 600 600 600 600 500 600 599
599 600 600 600 600 600 600 600 600 600 600 607  81  81 607 600 600 607  81  81 607 600 600 600 600 600 600 600 600 599
599 600 600 600 600 600 600 600 600 600 607 607  81  81 607 607 607 607  81  81 607 607 600 600 600 600 600 600 600 599
599 600 501 600 600 600 600 600 600 607  81  81  81  81  81  81  81  81  81  81  81  81 607 600 600 600 600 501 600 599
599 600 500 600 600 600 600 600 600 607  81  81  81  81  81  81  81  81  81  81  81  81 607 600 600 600 600 500 600 599
599 600 600 600 600 600 600 600 600 600 607 607  81  81 607 607 607 607  81  81 607 607 600 600 600 600 600 600 600 599
599 600 600 600 600 600 600 600 600 600 600 607  81  81 607 600 600 607  81  81 607 600 600 600 600 600 600 600 600 599
599 600 501 600 600 600 600 600 600 600 600 600 607 607 600 600 600 600 607 607 600 600 600 600 600 600 600 501 600 599
599 600 500 600 600 600 600 600 600 600 600 600 600 600 600 600 600 600 600 600 600 600 600 600 600 600 600 500 600 599
599 600 600 600 600 600 600 600 600 600 600 600 600 600 600 600 600 600 600 600 600 600 600 600 600 600 600 600 600 599
599 600 600 600 600 600 600 600 600 600 600 600 600 600 600 600 600 600 600 600 600 600 600 600 600 600 600 600 600 599
599 600 501 501 501 501 501 501 600 600 600 600 600 600 600 600 600 600 600 600 600 600 501 501 501 501 501 501 600 599
599 600 500 500 500 500 500 500 600 600 600 600 600 600 600 600 600 600 600 600 600 600 500 500 500 500 500 500 600 599
599 600 600 600 600 600 600 600 600 600 600 600 600 600 600 600 600 600 600 600 600 600 600 600 600 600 600 600 600 599
596 597 597 597 597 597 597 597 597 598 603 605 596 597 597 597 597 597 597 597 597 597 597 597 597 597 597 597 597 598
82   82  82  82  82  82  82  82  82  82 166 166
82
82
82
82
82
594 597 615 615 615 615 615 615 615 615 597 595 635 635 635 635 635 635 635 635 620 635 635 635 489 635 523 635 635 614
599 600 617 617 617 617 617 617 617 617 600 599 600 600 600 600 600 600 600 600 600 600 600 600 600 600 600 600 600 599
599 600 600 600 600 600 600 600 600 600 600 599 600 600 600 600 600 600 600 600 600 600 600 600 600 600 600 600 600 599
599 600 600 638 600 600 600 600 600 600 600 599 600 600 600 600 600 600 600 600 600 600 600 600 600 600 600 600 600 599
594 597 597 598 600 600 596 597 615 615 615 615 615 615 615 615 615 615 615 615 597 597 597 598 600 600 596 597 597 595
599 600 600 600 600 600 600 600 617 617 617 617 617 617 617 617 617 617 617 617 600 600 600 600 600 600 600 600 600 599
599 600 600 600 600 600 600 600 600 600 600 600 600 600 600 600 600 600 600 600 600 600 600 600 600 600 600 600 600 599
599 600 600 600 600 600 600 600 600 600 600 600 600 600 600 600 600 600 600 600 600 600 600 600 600 600 600 600 600 599
599 600 600 600 600 600 600 600 600 600 600 600 600 600  48 606 600 600  48 606 600 501 594 597 615 615 615 615 615 595
599 600 600 600 600 600 600 600 600 600 600 600 600 600 567 639 600 600 567 639 600 500 599 600 617 617 617 617 616 599
594 597 597 598 600 600 596 597 597 597 597 595 600 600 567 639 600 600 567 639 600 501 599 600 600 600 600 600 616 599
599 600 600 600 600 600 600 600 600 600 600 599 600 600 567 639 600 600 567 639 600 500 613 600 600 600 600 600 617 599
599 600  48 606 600 600 501 501 501 501 600 599 600 600 567 639 600 600 567 639 600 600 600 600 600 600 600 600 600 599
599 600 567 639 600 600 500 500 500 500 600 599 600 600 567 639 600 600 567 639 600 600 600 600 600 600 600 600 600 599
599 600 601 602 600 600 600 600 600 600 600 599 600 600 601 602 600 600 601 602 600 600 614 600  48 606 600 600 600 599
599 600 600 600 600 600 600 600 600 638 600 599 600 600 600 600 600 600 600 600 600 600 599 600 601 602 600 638 600 599
599 600 600 600 600 600 600 600 600 600 600 599 600 600 600 600 600 600 600 600 600 600 599 600 600 600 600 600 600 599
596 597 597 597 597 597 597 597 597 597 597 598 597 597 597 597 597 597 597 597 597 597 596 597 597 597 597 597 597 598