NAME
S.S. Anne Halls
NPCS
vermilion-house1-bookshelf3 blank 0 1
INTERACTIONS
MENU:ALERT:Crammed full of POK{e-accent}MON books!
END
TELEPORT
25 0 vermilion-harbor 14 2
26 0 vermilion-harbor 14 2
36 16 ss-anne-halls 25 28
26 28 ss-anne-halls 35 16
DATA
82   82  82  82  82  82  82  82  82  82  82  82  82  82  82  82  82  82  82  82  82  82  82  82  82 166 166  82
82   82  82  82  82  82  82  82  82  82  82  82  82  82  82  82  82  82  82  82  82  82  82  82 389 401 402 388
82   82  82  82  82  82  82  82  82  82  82  82  82  82  82  82  82  82  82  82  82  82  82  82 389 401 402 388
82   82  82  82  82  82  82  82  82  82  82  82  82  82  82  82  82  82  82  82  82  82  82  82 389 401 402 388
82   82  82  82  82  82  82  82  82  82  82  82  82  82  82  82  82  82  82  82  82  82  82  82 389 401 402 388
82  387 387 387 387 387 387 387 387 387 387 387 387 387 387 387 387 387 387 387 387 387 387 387 391 401 402 390 387 387 387 387 387 387 387 387 387  82
389 397 398 397 398 397 398 397 398 397 398 397 398 397 398 397 398 397 398 397 398 397 398 398 399 401 402 396 398 397 398 397 398 397 398 397 398 388
389 404 402 402 402 402 402 402 402 402 402 402 402 402 402 402 402 402 402 402 402 402 402 402 402 402 402 402 402 402 402 402 402 402 402 402 402 388
389 401 402 402 402 402 402 402 402 402 402 402 402 402 402 402 402 402 402 402 402 402 402 402 402 402 402 402 402 402 402 402 402 402 402 402 402 388
389 401 402 392 435 393 403 392 435 393 403 392 435 393 403 392 435 393 403 392 435 393 403 392 435 435 435 435 393 403 392 435 435 435 393 402 402 388
389 401 402 388  82 395 435 394  82 395 435 394  82 395 435 394  82 395 435 394  82 395 435 394  82  82  82  82 395 435 394  82  82  82 389 401 402 388
389 401 402 388  82  82  82  82  82  82  82  82  82  82  82  82  82  82  82  82  82  82  82  82  82  82  82  82  82  82  82  82  82  82 389 401 402 388
389 401 402 388  82  82  82  82  82  82  82  82  82  82  82  82  82  82  82  82  82  82  82  82  82  82  82  82  82  82  82  82  82  82 389 401 402 388
389 401 402 388  82  82  82  82  82  82  82  82  82  82  82  82  82  82  82  82  82  82  82  82  82  82  82  82  82  82  82  82  82  82 389 401 402 388
389 401 402 388  82  82  82  82  82  82  82  82  82  82  82  82  82  82  82  82  82  82  82  82  82  82  82  82  82  82  82  82  82  82 389 401 402 388
389 401 402 388  82  82  82  82  82  82  82  82  82  82  82  82  82  82  82  82  82  82  82  82  82  82  82  82  82  82  82  82  82  82 389 402 402 388
389 401 402 388  82  82  82  82  82  82  82  82  82  82  82  82  82  82  82  82  82  82  82  82  82  82  82  82  82  82  82  82  82  82 389 402 405 388
395 393 403 388  82  82  82  82  82  82  82  82  82  82  82  82  82  82  82  82  82  82  82  82  82  82  82  82  82  82  82  82  82  82 395 435 435 394
82  395 435 394
82
82
82
82
82
82
82  387 387 387 387 387 387 387 387 387 387 387 387 387 387 387 387 387 387 387 387 387 387 387 387 387 387
389 397 398 397 398 397 400 397 398 397 400 397 398 397 400 397 398 397 400 397 398 397 400 397 398 397 398 388
389 402 402 402 402 402 402 402 402 402 402 402 402 402 402 402 402 402 402 402 402 402 402 402 402 402 402 388
389 402 402 402 402 402 402 402 402 402 402 402 402 402 402 402 402 402 402 402 402 402 402 402 402 402 404 388
82  435 435 435 435 435 435 435 435 435 435 435 435 435 435 435 435 435 435 435 435 435 435 435 435 435 435  82
82
82
82
82
82
82
397 398 397 398 397 398 400 398 397 398 397 398 397 398
182 182 182 182 182 182 182 182 182 182 182 182 182 182
182 182 182 182 182 182 182 182 182 182 182 182 182 182
182 182 182 182 182 182 182 182 182 182 182 182 182 182
182 182 182 182 182 182 182 182 182 182 182 182 182 182
182 182
182 182
182 182
182 182
182 182
182 182
182 182 182 182 182 182 182 182 182 182 182 182 182 182
182 182 182 182 182 182 182 182 182 182 182 182 182 182
182 182 182 182 182 182 182 182 182 182 182 182 182 182