NAME
S.S. Anne Halls
NPCS
vermilion-house1-bookshelf3 blank 0 1
INTERACTIONS
MENU:ALERT:Crammed full of POK{e-accent}MON books!
END
TELEPORT
25 0 vermilion-harbor 14 2
26 0 vermilion-harbor 14 2
DATA
82   82  82  82  82  82  82  82  82  82  82  82  82  82  82  82  82  82  82  82  82  82  82  82  82 166 166  82
82   82  82  82  82  82  82  82  82  82  82  82  82  82  82  82  82  82  82  82  82  82  82  82 389 401 402 388
82   82  82  82  82  82  82  82  82  82  82  82  82  82  82  82  82  82  82  82  82  82  82  82 389 401 402 388
82   82  82  82  82  82  82  82  82  82  82  82  82  82  82  82  82  82  82  82  82  82  82  82 389 401 402 388
82   82  82  82  82  82  82  82  82  82  82  82  82  82  82  82  82  82  82  82  82  82  82  82 389 401 402 388
434 387 387 387 387 387 387 387 387 387 387 387 387 387 387 387 387 387 387 387 387 387 387 387 391 401 402 390 387 387 387 387 387 387 387 387 387 433
389 397 398 397 398 397 398 397 398 397 398 397 398 397 398 397 398 397 398 397 398 397 398 398 399 401 402 396 398 397 398 397 398 397 398 397 398 388
389 404 402 402 402 402 402 402 402 402 402 402 402 402 402 402 402 402 402 402 402 402 402 402 402 402 402 402 402 402 402 402 402 402 402 402 402 388
389 401 402 402 402 402 402 402 402 402 402 402 402 402 402 402 402 402 402 402 402 402 402 402 402 402 402 402 402 402 402 402 402 402 402 402 402 388
389 401 402 392
389 401 402 388
389 401 402 388
389 401 402 388
389 401 402 388
389 401 402 388
389 401 402 388
389 401 402 388
395 393 403 388
82  395 435 394



82 82
