NAME
Vermilion City
MAP
0.2975
-0.315
17
MUSIC
music/23-vermillion-city-loop.mp3
LEAVESOUND
sound_effects/general/sfx_go_inside.mp3
NPCS
vermillion-city-sign1 blank 32 5
INTERACTIONS
MENU:ALERT:VERMILION CITY{NEWLINE}The port of Exquisite Sunsets
END
vermilion-city-sign2 blank 12 15
INTERACTIONS
MENU:ALERT:POK{e-accent}MON FAN CLUB ALL POK{e-accent}MON fans welcome!
END
vermilion-city-sign3 blank 12 21
INTERACTIONS
MENU:ALERT:VERMILION CITY POK{e-accent}MON GYM|MENU:ALERT:LEADER: LT.SURGE|MENU:ALERT:The Lightning American!
END
vermilion-city-sign4 blank 34 17
INTERACTIONS
MENU:ALERT:VERMILION HARBOR
END
vermilion-city-sign5 blank 41 15
INTERACTIONS
MENU:ALERT:NOTICE!|MENU:ALERT:ROUTE 12 may be blocked off by a sleeping POK{e-accent}MON.|MENU:ALERT:Detour through ROCK TUNNEL to LAVENDER TOWN.|MENU:ALERT:-VERMILION POLICE
END
vermilion-city-man1 bald4 19 8
INTERACTIONS
MENU:ALERT:Did you see the S.S. ANNE moored in the harbor?
END
vermilion-city-woman1 woman4 25 9 WANDER
INTERACTIONS
MENU:ALERT:We're careful about pollution!|MENU:ALERT:We've heard GRIMER multiplies in toxic sludge!
END
vermilion-city-man2 bald4 34 9
INTERACTIONS
MENU:ALERT:I'm putting up a building on this plot of land.|MENU:ALERT:My POK{e-accent}MON is tamping the land.
END
vermilion-city-mon1 mon 33 10 WANDER
INTERACTIONS
PLAY_CRY:66-66|MENU:ALERT:MACHOP: Guoh! Gogogoh!|MENU:ALERT:A MACHOP is stomping the land flat.
END
vermilion-city-worker1 cap 32 29 WANDER
INTERACTIONS
MENU:ALERT:S.S. ANNE is a famous luxury cruise ship.|MENU:ALERT:We visit VERMILION CITY once a year.
END
vermilion-city-worker2 cap 24 32 UP
FORCE_INTERACTION
-1 0
END
INTERACTIONS
MENU:ALERT:Excuse me, do you have a ticket?|IN_INVENTORY:S.S. TICKET|{MENU:ALERT:Sorry!|MENU:ALERT:You need a ticket to get aboard.|MOVE:PLAYER:0,-1|NO_ADVANCE}{MENU:ALERT:{PLAYER_NAME} flashed the S.S. TICKET!|MENU:ALERT:Great! Welcome to the S.S. Anne!|DISABLE_FORCE}
MENU:ALERT:Welcome to the S.S. ANNE!
END
vermilion-city-bush1 bush 20 20
INTERACTIONS
HAS_MOVE:CUT|{}{MENU:ALERT:Used CUT!|CUT:}
END
vermilion-city-hidden blank 19 13 INCORPOREAL
INTERACTIONS
GIVE_ITEM:ETHER|DEACTIVATE:vermilion-city-hidden
END
TELEPORT
23 0 route6 13 35
24 0 route6 14 35
16 5 vermilion-center 3 7
12 5 vermilion-house1 2 7
20 15 vermilion-house2 2 7
28 21 vermilion-house3 2 7
28 15 vermilion-mart 3 7
14 15 vermilion-house4 3 7
23 34 vermilion-harbor 14 1
24 34 vermilion-harbor 14 1
17 21 vermilion-gym 4 17
44 16 route11 1 10
44 17 route11 1 11
NEIGHBORS
route6 10 -35
route11 43 6
WATER_ENCOUNTERS_OLD
129
WATER_ENCOUNTERS_GOOD
60 118
WATER_ENCOUNTERS_SUPER
72 90 98 116
LEVELS
10-15
DATA
81  81  81  81  81  81  81  81  81  81  81  81  81  81  81  81  81  81  81  81  81  81   0  56  56   0   1   1   1   1   1   1   1   1   1  76  76  76  76  76  76  76  76  76  76
81  81  81  81  81  81  81  81  81  81  81  81  81  81  81  81  81  81  81  81  81  81   0  56  56   0   1   1   1   1   1   1   1   1   1  76  76  76  76  76  76  76  76  76  76
81  81  81  81  81  81  81  81  81  81  81 332  71  71 333 332  71  71 333 332  71  71 103  56  56 102  71  71 103  56  56  56  56  56  56  56  56  56  56  56  56  56  56  56  56
81  81  81  81  81  81  81  81  81  81  81 334  68  68 335 334  68  68 335 334  68  68 105  56  56 104  68  68 105  56  56  56  56  56  56  56  56  56  56  56  56  56  56  56  56
81  81  81  81  81  81  81  81  81  81  81 108  65  65 109 108  65  65 109 108  65  65 109  56  56 108  65  65 109  56  56  56  56  56  56  56  56  56  56  56  56  56  56  56  56
81  81  81  81  81  81  81 656 656 656 656 110  15 164 112 110  15 113 112 110 164 164 112  56  56 110 164 164 112  55  55  55   5  55  55  55  55  55  55  56  56  56  56  56  56
81  81  81  81  81  81 656  81  81  81  89  56  56  56  56  56  56  56  56  56  56  56  56  56  56  56  56  56  56  56  56  56  56  56  56  56  56  56  55  56  56  56  56  56  56
81  81  81  81  81  81 656  81  81  81  89  56  56  56  56  56  56  56  56  56  56  56  56  56  56  56  56  56  56  56  56  56  56  56  56  56  56  56  55  56  56  56  56  56  56
81  81  81  81  81  81 656  81  81  81  87  88  88  88  91  56  56  56  56  56  56  56  56  56  56  56  56  56  56  56  56  56 322 323 323 324  56  56  55   3  56  56  56  56  56
81  81  81  81  81  81 656  81  81  81  81  81  81  81  89  56  56  56  56  56  56  56  56  56  56  56  56  56  56  56  56  56 242 328 330 243  56  56  55   3  56  56  56  56  56
81  81  81  81  81  81 656  81  81  81  81  81  81  81  87  88  88  88  88  88  91  56  56  56  56  56  56  56  56  56  56  56 242 329 331 243  56  56  55   3  56  56  56  56  56
81  81  81  81  81  81 656  81  81  81  81  81  81  81  81  81  81  81  81  81  89  56  56  56  56  56  56  56  56  56  56  56 325 326 326 327  56  56  55   3  56  56  56  56  56
81  81  81  81  81  81 656  81  81  81  81  81  81 332  71  71 333  81  81 332  71  71 103  56  56  56  56 102  71  71 103  56  56  56  56  56  56  56  55   3  56  56  56  56  56
81  81  81  81  81  81 656  81  81  81  81  81  81 334  68  68 335  81  81 334  68  68 105  56  56  56  56 104  68  68 105  56  56  56  56  56  56  56  55   3  56  56  56  56  56
81  81  81  81  81  81 656  81  81  81  89  56  56 108  65  65 109  56  56 108  65  65 109  56  56  56  56 108  65  65 109  56  56  56  56  56  56  56   0   0  56  56  56  56  56
81  81  81  81  81  81 656  81  81  81  89  56   5 110  15 164 112  56  56 110  15 164 112  56  56  56  56 110  15 111 112  55  55  55  55  55  55  55   0   0  55   5  55  55  55
81  81  81  81  81  81 656  81  81  81  89  56  56  56  56  56  56  56  56  56  56  56  56  56  56  56  56  56  56  56  56  56  56  56  56  56  56  56  56  56  56  56  56  56  56
81  81  81  81  81  81 656  81  81  81  89  56  56  56  56  56  56  56  56  56  56  56  56  56  56  56  56  56  56  56  56  56  56  56   5  56  56  56  56  56  56  56  56  56  56
81  81  81  81  81  81 656  81  81  81  89  56  56  70  71  71  71  71  72  56  56  56  56  56  56  56  56 102  71  71 103  92  88  88  91 238 238  92  88  88  88  88  88  88  88
81  81  81  81  81  81 656  81  81  81  89  56  56  67  68  68  68  68  69  56  56  56  56  56  56  56  56 104  68  68 105  90  81  81  89 238 238  90  81  81  81  81  81  81  81
81  81  81  81  81  81 656  81  81  81  89  56  56  61  62 100 101  62  66   1   1  92  88  88  91  56  56 108  65  65 109  90  81  81  89 238 238  90  81  81  81  81  81  81  81
81  81  81  81  81  81 656  81  81  81  89  55   5  57  58  58  58  15  60  76   1  90  81  81  89  56  56 110  15 164 112  90  81  81  89 238 238  90  81  81  81  81  81  81  81
81  81  81  81  81  81 656  81  81  81  89  56  56  56  56  56  56  56  56  56  56  90  81  81  89  56  56  56  56  56  56  90  81  81  87 238 238  86  81  81  81  81  81  81  81
81  81  81  81  81  81 656  81  81  81  89  56  56  56  56  56  56  56  56  56  56  90  81  81  89  56  56  56  56  56  56  90  81  81  81 238 238  81  81  81  81  81  81  81  81
81  81  81  81  81  81 656  81  81  81  89  56  56  56  56  56  56  56  56  56  56  90  81  81  87  88  88  88  88  88  88  86  81  81  81 238 238  81  81  81  81  89  76  76  76
81  81  81  81  81  81 656  81  81  81  89  56  56  56  56  56  56  56  56  56  56  90  81  81  81  81  81  81  81  81  81  81  81  81  81 238 238  81  81  81  81  89  76  76  76
81  81  81  81  81  81 656  81  81  81  87  88  88  88  88  88  88  88  88  88  88  86  81  81  81  81  81  81  81  81  81  81  81  81  81 238 238  81  81  81  81  89  76  76  76
81  81  81  81  81  81 656  81  81  81  81  81  81  81  81  81  81  81  81  81  81  81  81  81  81  81  81  81  81  81  81  81  81  81  81 238 238  81  81  81  81  89  76  76  76
81  81  81  81  81  81 656  81  81  81  81  81  81  81  81  81  81  81  81  81  81  81  81 238 238 238 238 238 238 238 238 238 238 238 238 238 238  81  81  81  81  87 656  88  88
81  81  81  81  81  81 656  81  81  81  81  81  81  81  81  81  81  81  81  81  81  81  81 238 238 238 238 238 238 238 238 238 238 238 238 238 238  81  81  81  81  81 656  81  81
81  81  81  81  81  81 656  81  81  81  81  81  81  81  81  81  81  81  81  81  81  81  81 238 238  81  81  81  81  81  81  81  81  81  81  81  81  81  81  81  81  81 656  81  81
81  81  81  81  81  81 656  81  81  81  81  81  81  81  81  81  81  81  81  81  81  81  81 238 238  81  81  81  81  81  81  81  81  81  81  81  81  81  81  81  81  81 656  81  81
81  81  81  81  81  81 656  81  81  81  81  81  81  81  81  81  81  81  81  81  81 656 656 238 238 656 656  81  81  81  81  81  81  81  81  81  81  81  81  81  81  81 656  81  81
81  81  81  81  81  81 656 656 656 656 656 656 656 656 656 656 656 656 656 656 656 656 656 238 238 656 656 656 656 656 656 656 656 656 656 656 656 656 656 656 656 656 656  81  81
81  81  81  81  81  81  81  81  81  81  81  81  81  81  81  81  81  81  81  81  81  81  81 238 238  81  81  81  81  81  81  81  81  81  81  81  81  81  81  81  81  81  81  81  81