NAME
Vermilion House 4
NPCS
vermilion-house4-pidgey bird 4 5
INTERACTIONS
MENU:ALERT:PIDGEY: Kurukkoo!
END
TELEPORT
2 8 vermilion-city 14 16
3 8 vermilion-city 14 16
DATA
336 337 338 339 340 336 337 336
18   18 341 342 343  18  18  18
18   18 345 346 347 348  18  18
18  344 349 350 351 352 344  18
18  344 353 354 354 355 344  18
18   18 356 357 358 359  18  18
18   18  18  18  18  18  18  18
18   18 279 279  18  18  18  18
82   82 166 166
