NAME
Victory Road
LEAVESOUND
sound_effects/general/sfx_go_outside.mp3
NPCS
victory-road-stone1 boulder 11 20 PUSHABLE TELEPORTABLE
INTERACTIONS
MENU:ALERT:This requires STRENGTH to move!|NO_ADVANCE
ACTIVATE:victory-road-stone2|DEACTIVATE:victory-road-block1|DEACTIVATE:victory-road-stone1
END
victory-road-stone2 boulder 23 18 INACTIVE
INTERACTIONS
MENU:ALERT:This requires STRENGTH to move!
END
victory-road-block1 block 15 17 NO_OFFSET
INTERACTIONS

END
victory-road-stone3 boulder 8 15 PUSHABLE
INTERACTIONS
MENU:ALERT:This requires STRENGTH to move!
END
victory-road-stone4 boulder 20 7 PUSHABLE
INTERACTIONS
MENU:ALERT:This requires STRENGTH to move!
END
victory-road-item1 orb 15 7
INTERACTIONS
GIVE_ITEM:RARE CANDY|DEACTIVATE:victory-road-item1
END
victory-road-item2 orb 17 5
INTERACTIONS
GIVE_ITEM:TM43|DEACTIVATE:victory-road-item2
END
victory-road-girl1 girl 13 10 RIGHT
FORCE_INTERACTION
1 0
2 0
3 0
END
INTERACTIONS
!:victory-road-girl1|MOVE_TO_PLAYER|MENU:ALERT:I wonder if you are good enough for me!|BATTLE:victory-road-girl1|{NO_ADVANCE}{DISABLE_FORCE}
MENU:ALERT:I never wanted to lose to anybody!
END
victory-road-guy1 guy2 9 7 DOWN
FORCE_INTERACTION
0 1
0 2
0 3
END
INTERACTIONS
!:victory-road-guy1|MOVE_TO_PLAYER|MENU:ALERT:I can see you're good! Let me see exactly how good!|BATTLE:victory-road-guy1|{NO_ADVANCE}{DISABLE_FORCE}
MENU:ALERT:I concede, you're better than me!
END
victory-road-stone5 boulder 10 38 PUSHABLE
INTERACTIONS
MENU:ALERT:This requires STRENGTH to move!
END
victory-road-block2 block 12 42 NO_OFFSET
INTERACTIONS

END
victory-road-block3 block 12 41 NO_OFFSET
INTERACTIONS

END
victory-road-stone6 boulder 6 49 INACTIVE
INTERACTIONS
MENU:ALERT:This requires STRENGTH to move!
END
victory-road-stone7 boulder 9 47 PUSHABLE TELEPORTABLE
INTERACTIONS
MENU:ALERT:This requires STRENGTH to move!|NO_ADVANCE
ACTIVATE:victory-road-stone6|DEACTIVATE:victory-road-block2|DEACTIVATE:victory-road-block3|DEACTIVATE:victory-road-stone7
END
victory-road-tough1 tough 18 47 UP
FORCE_INTERACTION
0 -1
0 -2
0 -3
END
INTERACTIONS
!:victory-road-tough1|MOVE_TO_PLAYER|MENU:ALERT:VICTORY ROAD is the final test for trainers!|BATTLE:victory-road-tough1|{NO_ADVANCE}{DISABLE_FORCE}
MENU:ALERT:If you get stuck, try moving some boulders around!
END
victory-road-guy2 guy2 26 46 LEFT
FORCE_INTERACTION
-1 0
-2 0
-3 0
END
INTERACTIONS
!:victory-road-guy2|MOVE_TO_PLAYER|MENU:ALERT:Ah, so you wish to challenge the ELITE FOUR?|BATTLE:victory-road-guy2|{NO_ADVANCE}{DISABLE_FORCE}
MENU:ALERT:{RIVAL_NAME} also came through here!
END
victory-road-guy3 guy2 24 41 DOWN
FORCE_INTERACTION
0 1
0 2
0 3
END
INTERACTIONS
!:victory-road-guy3|MOVE_TO_PLAYER|MENU:ALERT:Come on! {NEWLINE} I'll whip you!|BATTLE:victory-road-guy3|{NO_ADVANCE}{DISABLE_FORCE}
MENU:ALERT:You earned the right to be on VICTORY ROAD!
END
victory-road-item3 orb 23 42
INTERACTIONS
GIVE_ITEM:FULL HEAL|DEACTIVATE:victory-road-item3
END
victory-road-guy4 guy2 31 36 LEFT
FORCE_INTERACTION
-1 0
-2 0
-3 0
END
INTERACTIONS
!:victory-road-guy4|MOVE_TO_PLAYER|MENU:ALERT:Is VICTORY ROAD too tough?|BATTLE:victory-road-guy4|{NO_ADVANCE}{DISABLE_FORCE}
MENU:ALERT:Many trainers give up the challenge here.
END
victory-road-item4 orb 32 38
INTERACTIONS
GIVE_ITEM:TM17|DEACTIVATE:victory-road-item4
END
victory-road-guy5 guy2 33 67 LEFT
FORCE_INTERACTION
-1 0
END
INTERACTIONS
!:victory-road-guy5|MOVE_TO_PLAYER|MENU:ALERT:I heard rumors of a child prodigy!|BATTLE:victory-road-guy5|{NO_ADVANCE}{DISABLE_FORCE}
MENU:ALERT:You beat GIOVANNI of TEAM ROCKET?
END
victory-road-item5 orb 31 67
INTERACTIONS
GIVE_ITEM:MAX REVIVE|DEACTIVATE:victory-road-item5
END
victory-road-girl2 girl 18 65 RIGHT
FORCE_INTERACTION
1 0
2 0
3 0
END
INTERACTIONS
!:victory-road-girl2|MOVE_TO_PLAYER|MENU:ALERT:Trainers live to seek stronger opponents!|BATTLE:victory-road-girl2|{NO_ADVANCE}{DISABLE_FORCE}
MENU:ALERT:By fighting tough battles, you get stronger!
END
victory-road-block4 block 12 72 NO_OFFSET
INTERACTIONS

END
victory-road-stone8 boulder 27 65 PUSHABLE TELEPORTABLE
INTERACTIONS
MENU:ALERT:This requires STRENGTH to move!|NO_ADVANCE
ACTIVATE:victory-road-stone9|DEACTIVATE:victory-road-block4|DEACTIVATE:victory-road-stone8
END
victory-road-stone9 boulder 8 67 INACTIVE
INTERACTIONS
MENU:ALERT:This requires STRENGTH to move!
END
victory-road-item6 orb 12 69
INTERACTIONS
GIVE_ITEM:TM47|DEACTIVATE:victory-road-item6
END
victory-road-guy6 guy2 9 35 DOWN
FORCE_INTERACTION
0 1
END
INTERACTIONS
!:victory-road-guy6|MOVE_TO_PLAYER|MENU:ALERT:If you can get through here, you can go meet the ELITE FOUR!|BATTLE:victory-road-guy6|{NO_ADVANCE}{DISABLE_FORCE}
MENU:ALERT:I can beat you when it comes to knowledge about POK{e-accent}MON!
END
victory-road-item7 orb 16 33
INTERACTIONS
GIVE_ITEM:GUARD SPEC.|DEACTIVATE:victory-road-item7
END
victory-road-moltres bird 16 38 DOWN
INTERACTIONS
MENU:ALERT:Gyaoo!|WILD_BATTLE:146-146:50|{NO_ADVANCE}{DEACTIVATE:victory-road-moltres}
END
victory-road-guy7 guy2 11 76 LEFT
FORCE_INTERACTION
-1 0
-2 0
-3 0
END
INTERACTIONS
!:victory-road-guy7|MOVE_TO_PLAYER|MENU:ALERT:Only the chosen can pass here!|BATTLE:victory-road-guy7|{NO_ADVANCE}{DISABLE_FORCE}
MENU:ALERT:All trainers here are headed to the POK{e-accent}MON LEAGUE!|MENU:ALERT:Be careful!
END
victory-road-girl3 girl 12 75 RIGHT
FORCE_INTERACTION
1 0
2 0
3 0
END
INTERACTIONS
!:victory-road-girl3|MOVE_TO_PLAYER|MENU:ALERT:I'll show you just how good you are!|BATTLE:victory-road-girl3|{NO_ADVANCE}{DISABLE_FORCE}
MENU:ALERT:You showed me just how good I was!
END
victory-road-stone10 boulder 18 74 PUSHABLE
INTERACTIONS
MENU:ALERT:This requires STRENGTH to move!
END
victory-road-stone11 boulder 29 72 PUSHABLE
INTERACTIONS
MENU:ALERT:This requires STRENGTH to move!
END
victory-road-stone12 boulder 27 77 PUSHABLE TELEPORTABLE
INTERACTIONS
MENU:ALERT:This requires STRENGTH to move!|NO_ADVANCE
ACTIVATE:victory-road-stone13|DEACTIVATE:victory-road-stone12
END
victory-road-stone13 boulder 28 49 PUSHABLE TELEPORTABLE INACTIVE
INTERACTIONS
MENU:ALERT:This requires STRENGTH to move!|NO_ADVANCE
ACTIVATE:victory-road-stone14|DEACTIVATE:victory-road-block5|DEACTIVATE:victory-road-stone13
END
victory-road-block5 block 28 47 NO_OFFSET
INTERACTIONS

END
victory-road-stone14 boulder 14 49 INACTIVE
INTERACTIONS
MENU:ALERT:This requires STRENGTH to move!
END
victory-road-guy8 bald4 33 72 DOWN
FORCE_INTERACTION
0 1
0 2
0 3
END
INTERACTIONS
!:victory-road-guy8|MOVE_TO_PLAYER|MENU:ALERT:I'm on a lucky streak today!|BATTLE:victory-road-guy8|{NO_ADVANCE}{DISABLE_FORCE}
MENU:ALERT:Luck always runs out at some point...
END
TRAINERS
victory-road-girl1 35 0.75 0.75 COOLTRAINER{FEMALE} cooltrainerf.png {COOLTRAINER{FEMALE}: I lost out!}{} 123-53:68:SLASH,SCREECH,SWORDS DANCE,DOUBLE TEAM|38-53:68:SLASH,FLAMETHROWER,SCREECH,BITE
victory-road-guy1 35 0.75 0.75 COOLTRAINER{MALE} cooltrainerm.png {COOLTRAINER{MALE}: I had a chance...}{} 130-3:67:SOLAR BEAM,HYDROPUMP,BODY SLAM,BITE|94-9:65:HYDROPUMP,BODY SLAM,HYPNOSIS,LICK|76-6:66:FLAMETHROWER,EARTHQUAKE,SLASH,EXPLOSION|26-26:66:THUNDER,BODY SLAM,SUBMISSION,SWIFT
victory-road-tough1 25 0.65 0.65 BLACKBELT blackbelt.png {BLACKBELT: Aiyah!}{} 94-68:67:SUBMISSION,HYPNOSIS,LICK,DREAM EATER|9-68:66:SURF,SUBMISSION,BODY SLAM,ICE BEAM|68-28:68:SLASH,SUBMISSION,EARTHQUAKE,SEISMIC TOSS
victory-road-guy2 {OVERSWITCH} 35 0.95 0.95 JUGGLER juggler.png {JUGGLER: You got me!}{} 71-76:65:EXPLOSION,RAZOR LEAF,EARTHQUAKE,ROCK SLIDE|97-97:63:DREAM EATER,HYPNOSIS,HEADBUTT,POISON GAS|85-119:63:TRI ATTACK,WATERFALL,DRILL PECK,SUPERSONIC|38-38:66:TOXIC,CONFUSE RAY,FIRE SPIN,QUICK ATTACK|87-26:63:ICE BEAM,THUNDER,REST,BODY SLAM|68-68:64
victory-road-guy3 40 0.85 0.85 TAMER tamer.png {TAMER: I got whipped!}{} 123-53:68:SLASH,SCREECH,SWORDS DANCE,DOUBLE TEAM|55-55:68
victory-road-guy4 {OVERSWITCH} 35 0.95 0.95 JUGGLER juggler.png {JUGGLER: Well done!}{} 20-68:64:KARATE CHOP,HYPER FANG,SUPER FANG,SUBMISSION|45-26:64:THUNDER,PETAL DANCE,SWIFT,SLEEP POWDER|80-112:64:TAKE DOWN,AMNESIA,PSYCHIC,ROCK SLIDE|94-113:64:HYPNOSIS,LICK,DREAM EATER,SOFTBOILED|6-28:64:EARTHQUAKE,SLASH,FIRE BLAST,SWIFT|130-130:64:HYPER BEAM,HYDROPUMP,BITE,DRAGON RAGE
victory-road-guy5 35 0.75 0.75 COOLTRAINER{MALE} cooltrainerm.png {COOLTRAINER{MALE}: The rumors were true!}{} 82-103:67:PSYCHIC,MEGA DRAIN,EXPLOSION,THUNDER|91-91:66:SPIKE CANNON,ICE BEAM,CLAMP,SUPERSONIC|59-59:68:TAKE DOWN,BITE,FLAMETHROWER,LEER
victory-road-girl2 35 0.75 0.75 COOLTRAINER{FEMALE} cooltrainerf.png {COOLTRAINER{FEMALE}: Oh! So strong!}{} 76-47:68|87-59:67:ICE BEAM,FLAMETHROWER,REST,TAKE DOWN|80-113:66:PSYCHIC,SOFTBOILED,AMNESIA,MINIMIZE
victory-road-guy6 50 1.0 0.75 POK{e-accent}MANIAC pokemaniac.png {POK{e-accent}MANIAC: No! Unbelievable!}{} 6-76:66:FIRE SPIN,EXPLOSION,RAGE,ROCK SLIDE|45-131:64:ICE BEAM,PETAL DANCE,BODY SLAM,SURF|108-42:64:LICK,CONFUSE RAY,SLAM,WING ATTACK|112-108:65:HORN DRILL,SCREECH,STOMP,SUPERSONIC|51-26:66:EARTHQUAKE,THUNDER,SWIFT,BODY SLAM
victory-road-guy7 35 0.75 0.75 COOLTRAINER{MALE} cooltrainerm.png {COOLTRAINER{MALE}: I don't believe it!}{} 99-28:65:CRABHAMMER,SLASH,EARTHQUAKE,ICE BEAM|73-73:65:HYDROPUMP,SCREECH,BARRIER,ACID|78-9:70:DIG,HYDROPUMP,FIRE BLAST,TAKE DOWN
victory-road-girl3 35 0.75 0.75 COOLTRAINER{FEMALE} cooltrainerf.png {COOLTRAINER{FEMALE}: I'm furious!}{} 71-99:67:RAZOR LEAF,STOMP,SURF,GUILLOTINE|82-126:66:FLAMETHROWER,CONFUSE RAY,THUNDER,SWIFT|65-51:68:PSYCHIC,EARTHQUAKE,SLASH,PSYBEAM
victory-road-guy8 {NO_ACCURACY_CHECK} 70 0.95 0.95 GAMBLER gambler.png {GAMBLER: My lucky streak!}{} 112-112:63|34-34:65:THRASH,POISON STING,HORN ATTACK,FISSURE|51-99:64|31-31:63:BODY SLAM,POISON STING,TAIL WHIP,HORN DRILL|76-113:65:EARTHQUAKE,MINIMIZE,EXPLOSION,FISSURE|87-135:64:ICE BEAM,PIN MISSILE,THUNDERSHOCK,HORN DRILL
END
TELEPORT
14 23 route23 9 32 PLAYER
15 23 route23 9 32 PLAYER
23 18 victory-road 23 18 NPC
7 6 victory-road 5 40 PLAYER
5 41 victory-road 8 6 PLAYER
6 49 victory-road 6 49 NPC
28 40 victory-road 27 69 PLAYER
28 69 victory-road 27 40 PLAYER
8 67 victory-road 8 67 NPC
7 62 victory-road 6 35 PLAYER
6 34 victory-road 7 63 PLAYER
28 77 victory-road 27 49
14 49 victory-road 14 49 NPC
30 47 victory-road 31 77 PLAYER
32 77 victory-road 29 47
31 70 victory-road 32 41
32 40 victory-road 32 70
35 40 route23 19 32 PLAYER
35 41 route23 19 32 PLAYER
ENCOUNTERS
24 28 42 49 57 67 75 80 95 99 105 112
MEGA_ENCOUNTERS
136
LEVELS
55-60
MEGA_LEVELS
65-70
DATA
231 231 231 231 231 231 231 231 231 231 231 231 231 231 231 231 231 231 231 231 231 231 231 231 231 231 231 231 231 231 231
231 231 231 231 231 231 231 231 231 231 231 231 231 231 231 231 231 231 231 231 231 231 231 231 231 231 231 231 231 231 231
231 231 231 231 231 231 231 231 231 231 231 231 231 231 231 231 231 231 231 231 231 231 231 231 231 231 231 231 231 231 231
231 231 231 231 231 231 231 231 231 231 231 231 231 231 231 231 231 231 231 231 231 231 231 231 231 231 231 231 231 231 231
231 231 231 231 231 231 231 231 231 231 231 231 231 231 231 231 231 231 231 231 231 231 231 231 231 231 231 231 231 231 231
231 231 231 231 231 231 231 231 231 231 231 231 231 231 231 231 483 201 231 231 201 201 231 231 231 231 231 231 231 231 231
231 231 231 231 231 231 231 228 201 201 231 231 231 231 231 483 483 201 483 231 231 201 201 231 231 231 231 231 231 231 231
231 231 231 231 231 231 231 483 201 201 483 483 231 231 231 201 201 201 201 201 201 201 201 201 483 483 231 231 231 231 231
231 231 231 231 231 231 231 483 201 201 201 483 231 231 231 231 231 201 201 231 201 201 201 201 201 483 231 231 231 231 231
231 231 231 231 231 231 231 201 201 201 219 210 210 210 210 210 210 210 210 210 210 210 210 221 201 201 231 231 231 231 231
231 231 231 231 231 231 231 201 201 201 215 224 224 224 224 224 224 224 224 224 224 224 224 218 201 201 231 231 231 231 231
231 231 231 231 231 231 231 231 201 201 215 224 224 224 224 224 224 224 224 224 224 224 224 218 201 201 231 231 231 231 231
231 231 231 231 231 231 231 231 201 201 214 216 216 230 216 216 223 224 224 222 216 230 216 217 201 201 231 231 231 231 231
231 231 231 231 231 231 231 231 231 201 201 201 201 201 201 201 215 224 224 218 483 201 201 201 201 201 231 231 231 231 231
231 231 231 231 231 231 231 231 201 201 219 210 210 210 221 201 215 224 224 218 483 483 201 201 201 231 231 231 231 231 231
231 231 231 231 231 231 231 483 201 231 215 224 224 224 218 231 215 224 224 218 231 231 231 231 483 231 231 231 231 231 231
231 231 231 231 231 231 231 483 201 201 215 224 224 224 218 231 215 224 224 218 483 201 201 201 231 231 231 231 231 231 231
231 231 231 231 231 231 231 201 201 201 215 224 224 224 224 224 224 224 224 218 201 201 201 201 231 231 231 231 231 231 231
231 231 231 231 231 231 201 201 201 231 214 230 216 216 216 216 216 216 216 217 201 231 201 783 483 231 231 231 231 231 231
231 231 231 231 231 231 201 201 231 231 201 201 231 231 201 201 201 201 201 201 201 201 201 231 231 231 231 231 231 231 231
231 231 231 231 231 231 231 201 201 201 201 201 231 201 201 201 483 483 201 201 201 201 201 231 231 231 231 231 231 231 231
231 231 231 231 231 231 231 483 201 201 201 201 201 201 201 201 231 231 201 201 483 483 231 231 231 231 231 231 231 231 231
231 231 231 231 231 231 231 231 231 231 231 231 201 201 225 225 231 231 231 231 231 231 231 231 231 231 231 231 231 231 231
231 231 231 231 231 231 231 231 231 231 231 231 231 231 785 785 231 231 231 231 231 231 231 231 231 231 231 231 231 231 231
231 231 231 231 231 231 231 231 231 231 231 231 231 231 231 231 231 231 231 231 231 231 231 231 231 231 231 231 231 231 231
231 231 231 231 231 231 231 231 231 231 231 231 231 231 231 231 231 231 231 231 231 231 231 231 231 231 231 231 231 231 231
231 231 231 231 231 231 231 231 231 231 231 231 231 231 231 231 231 231 231 231 231 231 231 231 231 231 231 231 231 231 231
82
231 231 231 231 231 231 231 231 231 231 231 231 231 231 231 231 231 231 231 231 231 231 231 231 231 231 231 231 231 231 231 231 231 231 231 231 231 231 231 231
231 231 231 231 231 231 231 231 231 231 231 231 231 231 231 231 231 231 231 231 231 231 231 231 231 231 231 231 231 231 231 231 231 231 231 231 231 231 231 231
231 231 231 231 231 231 231 231 231 231 231 231 231 231 231 231 231 231 231 231 231 231 231 231 231 231 231 231 231 231 231 231 231 231 231 231 231 231 231 231
231 231 231 231 231 231 231 231 231 231 231 231 231 231 231 231 231 231 231 231 231 231 231 231 231 231 231 231 231 231 231 231 231 231 231 231 231 231 231 231
231 231 231 231 231 231 231 231 231 231 231 231 231 231 231 231 231 231 231 231 231 231 231 231 231 231 231 231 231 231 231 231 231 231 231 231 231 231 231 231
231 231 231 231 231 231 231 784 784 784 784 784 784 784 784 784 784 784 784 231 201 784 784 784 784 784 784 784 784 784 784 784 784 201 231 231 231 231 231 231
231 231 231 231 231 231 228 784 784 784 784 784 784 784 784 784 784 784 784 231 201 784 784 784 784 784 784 784 784 784 784 784 784 201 231 231 231 231 231 231
231 231 231 231 231 231 201 784 784 201 231 784 784 784 784 784 784 784 784 231 201 784 784 784 784 784 784 784 784 784 784 784 784 201 231 231 231 231 231 231
231 231 231 231 231 231 201 784 784 201 201 784 784 784 784 784 784 784 784 231 201 784 784 784 784 784 784 784 784 784 784 784 784 201 231 231 231 231 231 231
231 231 231 231 231 231 231 231 231 231 201 231 231 231 201 784 784 784 784 231 201 784 784 231 231 231 231 231 231 231 201 784 784 201 231 231 231 231 231 231
231 231 231 231 231 231 201 201 201 201 201 231 201 231 201 784 784 784 784 231 201 784 784 201 201 201 201 201 201 231 201 784 784 201 231 231 231 231 231 231
231 231 231 231 231 201 201 784 784 784 784 784 784 231 201 784 784 784 784 231 201 784 784 784 784 784 784 201 201 231 231 231 231 231 231 231 231 231 231 231
231 231 231 231 231 201 201 784 784 784 784 784 784 231 201 784 784 784 784 231 201 784 784 784 784 784 784 201 228 231 201 231 228 201 225 785 231 231 231 231
231 231 231 231 231 227 231 784 784 219 210 210 210 210 210 210 210 210 210 210 221 784 784 784 784 784 784 784 784 231 201 784 784 201 225 785 231 231 231 231
231 231 231 231 231 201 201 784 784 215 224 224 224 224 224 224 224 224 224 224 218 784 784 784 784 784 784 784 784 231 201 784 784 201 231 231 231 231 231 231
231 231 231 231 231 231 201 784 784 214 230 216 216 216 216 216 216 223 224 224 218 784 784 784 784 784 784 784 784 231 231 231 231 231 231 231 231 231 231 231
231 231 231 231 231 231 201 784 784 201 201 201 201 231 201 201 201 215 224 224 218 784 784 784 784 784 784 784 784 201 201 201 201 201 201 231 231 231 231 231
231 231 231 231 231 231 483 784 784 784 784 784 784 231 201 784 784 215 224 224 224 210 210 210 210 210 210 231 210 210 210 210 221 784 784 231 231 231 231 231
231 231 231 231 231 231 483 784 784 784 784 784 784 231 201 784 784 215 224 224 224 224 224 224 224 224 224 231 224 224 224 224 218 784 784 231 231 231 231 231
231 231 231 231 231 231 201 201 201 784 784 784 784 231 201 784 784 215 224 224 224 224 224 224 224 224 224 224 224 224 228 224 218 784 784 231 231 231 231 231
231 231 231 231 231 231 201 231 201 784 784 784 784 231 201 784 784 214 216 216 230 216 216 216 216 216 230 216 216 216 216 216 217 784 784 231 231 231 231 231
231 231 231 231 231 231 783 201 201 201 231 231 231 231 783 784 784 784 784 784 784 784 784 784 784 784 784 784 784 784 784 784 784 784 784 231 231 231 231 231
231 231 231 231 231 231 231 231 231 231 231 231 231 231 231 784 784 784 784 784 784 784 784 784 784 784 784 784 784 784 784 784 784 784 784 231 231 231 231 231
231 231 231 231 231 231 231 231 231 231 231 231 231 231 231 231 231 231 231 231 231 231 231 231 231 231 231 231 231 231 231 231 231 231 231 231 231 231 231 231
231 231 231 231 231 231 231 231 231 231 231 231 231 231 231 231 231 231 231 231 231 231 231 231 231 231 231 231 231 231 231 231 231 231 231 231 231 231 231 231
231 231 231 231 231 231 231 231 231 231 231 231 231 231 231 231 231 231 231 231 231 231 231 231 231 231 231 231 231 231 231 231 231 231 231 231 231 231 231 231
231 231 231 231 231 231 231 231 231 231 231 231 231 231 231 231 231 231 231 231 231 231 231 231 231 231 231 231 231 231 231 231 231 231 231 231 231 231 231 231
231 231 231 231 231 231 231 231 231 231 231 231 231 231 231 231 231 231 231 231 231 231 231 231 231 231 231 231 231 231 231 231 231 231 231 231 231 231 231 231
82
231 231 231 231 231 231 231 231 231 231 231 231 231 231 231 231 231 231 231 231 231 231 231 231 231 231 231 231 231 231 231 231 231 231 231 231 231 231 231
231 231 231 231 231 231 231 231 231 231 231 231 231 231 231 231 231 231 231 231 231 231 231 231 231 231 231 231 231 231 231 231 231 231 231 231 231 231 231
231 231 231 231 231 231 231 231 231 231 231 231 231 231 231 231 231 231 231 231 231 231 231 231 231 231 231 231 231 231 231 231 231 231 231 231 231 231 231
231 231 231 231 231 231 231 231 231 231 231 231 231 231 231 231 231 231 231 231 231 231 231 231 231 231 231 231 231 231 231 231 231 231 231 231 231 231 231
231 231 231 231 231 231 231 231 231 231 231 231 231 231 231 231 231 231 231 231 231 231 231 231 231 231 231 231 231 231 231 231 231 231 231 231 231 231 231
231 231 231 231 231 231 483 227 231 231 231 784 784 784 784 784 784 784 784 784 784 784 784 784 784 784 784 784 784 784 784 784 784 201 231 231 231 231 231
231 231 231 231 231 231 483 201 201 483 231 784 784 784 784 784 784 784 784 784 784 784 784 784 784 784 784 784 784 784 784 784 784 201 231 231 231 231 231
231 231 231 231 231 231 231 201 201 201 201 784 784 219 210 210 210 210 210 210 210 210 210 210 221 784 784 784 784 784 784 201 201 201 231 231 231 231 231
231 231 231 231 231 231 201 201 231 201 231 784 784 215 224 224 224 224 224 224 224 224 224 224 218 784 784 784 784 784 784 231 201 201 231 231 231 231 231
231 231 231 231 231 231 201 201 201 201 231 784 784 215 224 224 224 224 224 224 224 224 224 224 218 784 784 784 784 206 207 231 201 201 231 231 231 231 231
231 231 231 231 231 231 201 201 783 231 231 784 784 215 224 224 222 216 216 216 216 216 230 216 217 784 784 784 784 202 203 201 201 201 231 231 231 231 231
231 231 231 231 231 201 201 483 483 483 483 201 201 215 224 224 218 784 784 784 784 784 784 784 784 784 784 201 201 231 231 231 231 231 231 231 231 231 231
231 231 231 231 231 219 210 210 210 210 210 221 201 215 224 224 218 784 784 784 784 784 784 784 784 784 784 201 227 231 201 201 201 201 231 231 231 231 231
231 231 231 231 231 215 224 224 224 224 224 218 231 215 224 224 218 784 784 784 784 201 231 231 231 201 201 201 201 231 201 227 201 201 231 231 231 231 231
231 231 231 231 231 214 230 216 216 223 224 218 231 215 224 224 218 784 784 784 784 201 201 231 201 201 231 231 231 231 201 201 201 201 231 231 231 231 231
231 231 231 231 231 231 201 784 784 215 224 224 224 224 224 224 218 784 784 784 784 784 784 784 784 201 231 784 784 201 201 231 201 201 231 231 231 231 231
231 231 231 231 231 231 201 784 784 214 216 216 216 216 216 216 217 784 784 784 784 784 784 784 784 201 231 784 784 231 201 201 201 201 231 231 231 231 231
231 231 231 231 231 231 201 784 784 784 784 784 784 784 784 784 784 231 201 231 231 231 231 231 231 231 231 784 784 231 201 784 784 201 231 231 231 231 231
231 231 231 231 231 231 201 784 784 784 784 784 784 784 784 784 784 231 201 201 201 201 201 201 201 201 201 784 784 231 201 784 784 201 231 231 231 231 231
231 231 231 231 231 231 201 784 784 784 784 784 784 784 784 784 784 206 207 784 784 784 784 784 784 784 784 201 201 231 201 201 201 201 231 231 231 231 231
231 231 231 231 231 231 201 784 784 784 784 784 784 784 784 784 784 202 203 784 784 784 784 784 784 784 784 201 728 231 201 201 227 201 231 231 231 231 231
231 231 231 231 231 206 207 201 201 201 201 201 201 201 201 201 201 201 201 201 201 201 201 201 201 201 201 201 201 231 201 201 201 206 207 231 231 231 231
231 231 231 231 231 202 203 231 231 231 231 231 231 231 231 231 231 231 231 231 231 231 231 231 231 231 231 231 231 231 231 231 231 202 203 231 231 231 231
231 231 231 231 231 231 231 231 231 231 231 231 231 231 231 231 231 231 231 231 231 231 231 231 231 231 231 231 231 231 231 231 231 231 231 231 231 231 231
231 231 231 231 231 231 231 231 231 231 231 231 231 231 231 231 231 231 231 231 231 231 231 231 231 231 231 231 231 231 231 231 231 231 231 231 231 231 231
231 231 231 231 231 231 231 231 231 231 231 231 231 231 231 231 231 231 231 231 231 231 231 231 231 231 231 231 231 231 231 231 231 231 231 231 231 231 231
231 231 231 231 231 231 231 231 231 231 231 231 231 231 231 231 231 231 231 231 231 231 231 231 231 231 231 231 231 231 231 231 231 231 231 231 231 231 231
231 231 231 231 231 231 231 231 231 231 231 231 231 231 231 231 231 231 231 231 231 231 231 231 231 231 231 231 231 231 231 231 231 231 231 231 231 231 231