NAME
Viridian Pok{e-accent}center
NPCS
viridian-center-bookshelf1 blank 7 1 NO_WANDER
INTERACTIONS
MENU:ALERT:Crammed full of POK{e-accent}MON books!
END
TELEPORT
2 8 viridian-city 21 16
3 8 viridian-city 21 16
DATA
134 135 136 137 138 134 135 136 139 139 140 139 140 139
134 141 142 143 123 134 144 145 123 123 123 123 123 123
146 147 148 149 148 146 148 148 148 148 150 123 150 148
123 123 123 123 123 123 123 123 123 123 123 123 123 151
152 153 123 123 123 123 123 123 123 123 123 123 123 154
155 122 123 123 123 123 123 123 123 123 123 123 123 123
156 156 123 123 123 123 156 156 123 123 123 123 156 156
157 157 123  54  54 123 157 157 123 123 123 123 157 157
82   82  82  81  81