NAME
Viridian City Mart
NPCS
viridian-house2-bookshelf1 blank 7 1 NO_WANDER
INTERACTIONS
MENU:ALERT:Crammed full of POK{e-accent}MON books!
END
TELEPORT
3 8 viridian-city 29 20
4 8 viridian-city 29 20
DATA
118 118 119 119 119 119 118 118
120 120 121 121 121 121 120 120
122 123 123 123 123 123 123 123
124 125 123 123 124 125 124 125
128 129 122 123 126 127 126 127
122 130 122 123 123 123 123 123
131 132 122 123 123 123 123 123
122 123 123 133 133 123 123 123
82   82  82  81  81